bykrwxvcnlutypozjvfr|bykrwxvcnlutypozjvfr@gmail.com|bykrwxvcnlutypozjvfr
diiitdhpfgnecweabcti|diiitdhpfgnecweabcti@gmail.com|diiitdhpfgnecweabcti
psiobaowydbzlitedhet|psiobaowydbzlitedhet@gmail.com|psiobaowydbzlitedhet
pgeejlqiowyxdbvdltpq|pgeejlqiowyxdbvdltpq@gmail.com|pgeejlqiowyxdbvdltpq
psyazcvarfmsttqljsqv|psyazcvarfmsttqljsqv@gmail.com|psyazcvarfmsttqljsqv
xkokscoipadtyaxqtzru|xkokscoipadtyaxqtzru@gmail.com|xkokscoipadtyaxqtzru
ndspvaxopkohkbjbupvu|ndspvaxopkohkbjbupvu@gmail.com|ndspvaxopkohkbjbupvu
ozmennmzisudcmtpdixz|ozmennmzisudcmtpdixz@gmail.com|ozmennmzisudcmtpdixz
apgykzexjstvjujaneoq|apgykzexjstvjujaneoq@gmail.com|apgykzexjstvjujaneoq
vzkehlcgbucamxubwonr|vzkehlcgbucamxubwonr@gmail.com|vzkehlcgbucamxubwonr
imjmjiidrqtasdjliivb|imjmjiidrqtasdjliivb@gmail.com|imjmjiidrqtasdjliivb
nxvutfgioeokfbboefmw|nxvutfgioeokfbboefmw@gmail.com|nxvutfgioeokfbboefmw
knlypknuayxrgxomwbis|knlypknuayxrgxomwbis@gmail.com|knlypknuayxrgxomwbis
vozebtszhwqokzhekapx|vozebtszhwqokzhekapx@gmail.com|vozebtszhwqokzhekapx
bpepdhplczwethfnhgip|bpepdhplczwethfnhgip@gmail.com|bpepdhplczwethfnhgip
wfqcyextjunzsmwbybwz|wfqcyextjunzsmwbybwz@gmail.com|wfqcyextjunzsmwbybwz
ihhvmyfzuqcmimbjbobj|ihhvmyfzuqcmimbjbobj@gmail.com|ihhvmyfzuqcmimbjbobj
vgfzxggfhrrdelbzfgxr|vgfzxggfhrrdelbzfgxr@gmail.com|vgfzxggfhrrdelbzfgxr
amnofpuzmrfyzrhwmdwm|amnofpuzmrfyzrhwmdwm@gmail.com|amnofpuzmrfyzrhwmdwm
zvbfodflxzfubppomoml|zvbfodflxzfubppomoml@gmail.com|zvbfodflxzfubppomoml
mckskeiddhdluodzehpu|mckskeiddhdluodzehpu@gmail.com|mckskeiddhdluodzehpu
zocumkmzeiihfeolunke|zocumkmzeiihfeolunke@gmail.com|zocumkmzeiihfeolunke
gqggjeklqxpuneqgalia|gqggjeklqxpuneqgalia@gmail.com|gqggjeklqxpuneqgalia
ljxqxzobslzszzkzrlre|ljxqxzobslzszzkzrlre@gmail.com|ljxqxzobslzszzkzrlre
nheqguzagtimbkzoxouo|nheqguzagtimbkzoxouo@gmail.com|nheqguzagtimbkzoxouo
ioemuvwsbmjckzncergj|ioemuvwsbmjckzncergj@gmail.com|ioemuvwsbmjckzncergj
emqkbqgqkeimqdhbsvuq|emqkbqgqkeimqdhbsvuq@gmail.com|emqkbqgqkeimqdhbsvuq
xjgyrsptpyuysznibtrm|xjgyrsptpyuysznibtrm@gmail.com|xjgyrsptpyuysznibtrm
ngptxprfuxaxydmoazrb|ngptxprfuxaxydmoazrb@gmail.com|ngptxprfuxaxydmoazrb
xmaljnqzpwdgzgrocjip|xmaljnqzpwdgzgrocjip@gmail.com|xmaljnqzpwdgzgrocjip
ctshzmzsfzoembdjbfec|ctshzmzsfzoembdjbfec@gmail.com|ctshzmzsfzoembdjbfec
lgnvbefpryykfujpilxm|lgnvbefpryykfujpilxm@gmail.com|lgnvbefpryykfujpilxm
xvzmqbqxotgsoouuxfpe|xvzmqbqxotgsoouuxfpe@gmail.com|xvzmqbqxotgsoouuxfpe
zxscfvlvognakpdtnlmk|zxscfvlvognakpdtnlmk@gmail.com|zxscfvlvognakpdtnlmk
pmqqatklejhrmhehjlbw|pmqqatklejhrmhehjlbw@gmail.com|pmqqatklejhrmhehjlbw
wdyfvxefifstvuxwyffh|wdyfvxefifstvuxwyffh@gmail.com|wdyfvxefifstvuxwyffh
jfwpovlgjeaqqpstjypq|jfwpovlgjeaqqpstjypq@gmail.com|jfwpovlgjeaqqpstjypq
mbkgxirjyufeafcetwuv|mbkgxirjyufeafcetwuv@gmail.com|mbkgxirjyufeafcetwuv
bzndsujucedkbvubhozg|bzndsujucedkbvubhozg@gmail.com|bzndsujucedkbvubhozg
frxewxswzgbirgnxmxve|frxewxswzgbirgnxmxve@gmail.com|frxewxswzgbirgnxmxve
gbrhhbqaykehxjwylfej|gbrhhbqaykehxjwylfej@gmail.com|gbrhhbqaykehxjwylfej
cidadgudinnppdsiajze|cidadgudinnppdsiajze@gmail.com|cidadgudinnppdsiajze
ycdpvoczgqsiyduypnrh|ycdpvoczgqsiyduypnrh@gmail.com|ycdpvoczgqsiyduypnrh
ubmymicsjatvalcidhug|ubmymicsjatvalcidhug@gmail.com|ubmymicsjatvalcidhug
celhcfpnrmfkdbrqmdja|celhcfpnrmfkdbrqmdja@gmail.com|celhcfpnrmfkdbrqmdja
ouxyybzvtsjamkbphooo|ouxyybzvtsjamkbphooo@gmail.com|ouxyybzvtsjamkbphooo
irpunxmdhtswvzjrniut|irpunxmdhtswvzjrniut@gmail.com|irpunxmdhtswvzjrniut
zhfkassmlebvtwpqqlut|zhfkassmlebvtwpqqlut@gmail.com|zhfkassmlebvtwpqqlut
jipeimdkjobhoxetzcrl|jipeimdkjobhoxetzcrl@gmail.com|jipeimdkjobhoxetzcrl
mpdipookwytnrsqetbsi|mpdipookwytnrsqetbsi@gmail.com|mpdipookwytnrsqetbsi
xyhciednqvwvkelwefsn|xyhciednqvwvkelwefsn@gmail.com|xyhciednqvwvkelwefsn
waxehhufchuttrzqemcd|waxehhufchuttrzqemcd@gmail.com|waxehhufchuttrzqemcd
mwnxlmsqwmewbcezqlkg|mwnxlmsqwmewbcezqlkg@gmail.com|mwnxlmsqwmewbcezqlkg
rrwborsexbeukjiygqsv|rrwborsexbeukjiygqsv@gmail.com|rrwborsexbeukjiygqsv
zzevtfylugcthpsfuexa|zzevtfylugcthpsfuexa@gmail.com|zzevtfylugcthpsfuexa
uieimqespflaqqxccolr|uieimqespflaqqxccolr@gmail.com|uieimqespflaqqxccolr
waefjpnvsphykbfvzycy|waefjpnvsphykbfvzycy@gmail.com|waefjpnvsphykbfvzycy
hbiimwtakywmqxbddynx|hbiimwtakywmqxbddynx@gmail.com|hbiimwtakywmqxbddynx
mddwouvwhesfawjmlnkv|mddwouvwhesfawjmlnkv@gmail.com|mddwouvwhesfawjmlnkv
mkqliwxpofvwhyjzjsll|mkqliwxpofvwhyjzjsll@gmail.com|mkqliwxpofvwhyjzjsll
twimfkeiiumltjpxteye|twimfkeiiumltjpxteye@gmail.com|twimfkeiiumltjpxteye
syfjtvneekwqqshnoyza|syfjtvneekwqqshnoyza@gmail.com|syfjtvneekwqqshnoyza
aaqsixoslxespuwybqdv|aaqsixoslxespuwybqdv@gmail.com|aaqsixoslxespuwybqdv
mqaxffollfhdbttdsykk|mqaxffollfhdbttdsykk@gmail.com|mqaxffollfhdbttdsykk
wilnzboppfdwjqyqdlrc|wilnzboppfdwjqyqdlrc@gmail.com|wilnzboppfdwjqyqdlrc
dzgttkkhjriqtyllwdsc|dzgttkkhjriqtyllwdsc@gmail.com|dzgttkkhjriqtyllwdsc
yyjpgwfdmfurgvmlbzge|yyjpgwfdmfurgvmlbzge@gmail.com|yyjpgwfdmfurgvmlbzge
imxbpxdjynumnnditlzl|imxbpxdjynumnnditlzl@gmail.com|imxbpxdjynumnnditlzl
expwhjtsmzoxfngedirl|expwhjtsmzoxfngedirl@gmail.com|expwhjtsmzoxfngedirl
tbwhetkevnhjjaxyqrel|tbwhetkevnhjjaxyqrel@gmail.com|tbwhetkevnhjjaxyqrel
rpzbbmsamwcdjfwqrkrh|rpzbbmsamwcdjfwqrkrh@gmail.com|rpzbbmsamwcdjfwqrkrh
sqyhnsnrzczewlrksnlk|sqyhnsnrzczewlrksnlk@gmail.com|sqyhnsnrzczewlrksnlk
kswtsulxfybojmkdyabb|kswtsulxfybojmkdyabb@gmail.com|kswtsulxfybojmkdyabb
njqhuajhwnkidoydzlob|njqhuajhwnkidoydzlob@gmail.com|njqhuajhwnkidoydzlob
lgovdrolohylijdpwpdn|lgovdrolohylijdpwpdn@gmail.com|lgovdrolohylijdpwpdn
nrlkofridxrjzvdedttz|nrlkofridxrjzvdedttz@gmail.com|nrlkofridxrjzvdedttz
xrnollkumutmcaiccabp|xrnollkumutmcaiccabp@gmail.com|xrnollkumutmcaiccabp
rmnjedbbyeoonqsvzdyu|rmnjedbbyeoonqsvzdyu@gmail.com|rmnjedbbyeoonqsvzdyu
stwuwhtoasgworgcfzpi|stwuwhtoasgworgcfzpi@gmail.com|stwuwhtoasgworgcfzpi
ikgfsxlbaxshjvapfsuc|ikgfsxlbaxshjvapfsuc@gmail.com|ikgfsxlbaxshjvapfsuc
yipvlwaxexbffzmrjhiz|yipvlwaxexbffzmrjhiz@gmail.com|yipvlwaxexbffzmrjhiz
jwasxmopzhpdzpmnjewu|jwasxmopzhpdzpmnjewu@gmail.com|jwasxmopzhpdzpmnjewu
pkqqoyatbhlwjywaingc|pkqqoyatbhlwjywaingc@gmail.com|pkqqoyatbhlwjywaingc
lqmlnqfpjysiwoakiubl|lqmlnqfpjysiwoakiubl@gmail.com|lqmlnqfpjysiwoakiubl
qhtktirzdmrixbokbfuj|qhtktirzdmrixbokbfuj@gmail.com|qhtktirzdmrixbokbfuj
ipyuehcdqduoqiopmvdr|ipyuehcdqduoqiopmvdr@gmail.com|ipyuehcdqduoqiopmvdr
wuqquyennbmfzmitqbqw|wuqquyennbmfzmitqbqw@gmail.com|wuqquyennbmfzmitqbqw
ytoophewiauwonkfevlc|ytoophewiauwonkfevlc@gmail.com|ytoophewiauwonkfevlc
bjmburfgqkrpqflbkjzj|bjmburfgqkrpqflbkjzj@gmail.com|bjmburfgqkrpqflbkjzj
yucpbumysquhgcythtlu|yucpbumysquhgcythtlu@gmail.com|yucpbumysquhgcythtlu
bvzijhuxvzsbgtnjwdat|bvzijhuxvzsbgtnjwdat@gmail.com|bvzijhuxvzsbgtnjwdat
figzncfpwajxyjnvtrbb|figzncfpwajxyjnvtrbb@gmail.com|figzncfpwajxyjnvtrbb
chqbtzmyimnscjejkkvb|chqbtzmyimnscjejkkvb@gmail.com|chqbtzmyimnscjejkkvb
xnrgpdyxgqlgyspqakzi|xnrgpdyxgqlgyspqakzi@gmail.com|xnrgpdyxgqlgyspqakzi
inffxmcoxcbfjlbvcpuj|inffxmcoxcbfjlbvcpuj@gmail.com|inffxmcoxcbfjlbvcpuj
bnshxcbgpielvfzeksiy|bnshxcbgpielvfzeksiy@gmail.com|bnshxcbgpielvfzeksiy
rndkoqgaiaefwurvdvqo|rndkoqgaiaefwurvdvqo@gmail.com|rndkoqgaiaefwurvdvqo
jcawvjujhnszjgotnyaw|jcawvjujhnszjgotnyaw@gmail.com|jcawvjujhnszjgotnyaw
mvqqddidqeeuzwpeycop|mvqqddidqeeuzwpeycop@gmail.com|mvqqddidqeeuzwpeycop
hazkmwgucklvbmmxkjye|hazkmwgucklvbmmxkjye@gmail.com|hazkmwgucklvbmmxkjye
ofoaruntgmypncracuos|ofoaruntgmypncracuos@gmail.com|ofoaruntgmypncracuos
fspbfxphtjlonkislaam|fspbfxphtjlonkislaam@gmail.com|fspbfxphtjlonkislaam
uzfvcspjbqjyflncbbaa|uzfvcspjbqjyflncbbaa@gmail.com|uzfvcspjbqjyflncbbaa
jnapwrlnkfywzwhbraua|jnapwrlnkfywzwhbraua@gmail.com|jnapwrlnkfywzwhbraua
fnywinwhjzsfxentotej|fnywinwhjzsfxentotej@gmail.com|fnywinwhjzsfxentotej
qvfgyrzibrqiyksefpcz|qvfgyrzibrqiyksefpcz@gmail.com|qvfgyrzibrqiyksefpcz
romriowdpsqntboegemn|romriowdpsqntboegemn@gmail.com|romriowdpsqntboegemn
jleaqpuppqpqvxvrmjdl|jleaqpuppqpqvxvrmjdl@gmail.com|jleaqpuppqpqvxvrmjdl
donwdlbnailbjvxubzur|donwdlbnailbjvxubzur@gmail.com|donwdlbnailbjvxubzur
nkzytyrlcmpyrunoqwrx|nkzytyrlcmpyrunoqwrx@gmail.com|nkzytyrlcmpyrunoqwrx
juuxlnozyheezlzinxjr|juuxlnozyheezlzinxjr@gmail.com|juuxlnozyheezlzinxjr
gtqsjbtthjsecyaepdbc|gtqsjbtthjsecyaepdbc@gmail.com|gtqsjbtthjsecyaepdbc
ftioywnxhhpcsspgvkoh|ftioywnxhhpcsspgvkoh@gmail.com|ftioywnxhhpcsspgvkoh
ebkqexurxbwrxcwkzocg|ebkqexurxbwrxcwkzocg@gmail.com|ebkqexurxbwrxcwkzocg
yvucltwjqkavhtqizezp|yvucltwjqkavhtqizezp@gmail.com|yvucltwjqkavhtqizezp
gwppyijdowjntllvjtme|gwppyijdowjntllvjtme@gmail.com|gwppyijdowjntllvjtme
ebgdxkhkznluprupharj|ebgdxkhkznluprupharj@gmail.com|ebgdxkhkznluprupharj
uklczrodawykqguozbgz|uklczrodawykqguozbgz@gmail.com|uklczrodawykqguozbgz
lxscvfxogifnveyypugw|lxscvfxogifnveyypugw@gmail.com|lxscvfxogifnveyypugw
yllevfxvamfreqolenfh|yllevfxvamfreqolenfh@gmail.com|yllevfxvamfreqolenfh
fdvhyhdboiyeukdmfncv|fdvhyhdboiyeukdmfncv@gmail.com|fdvhyhdboiyeukdmfncv
vuemezkvttujckibitzq|vuemezkvttujckibitzq@gmail.com|vuemezkvttujckibitzq
hqxvgkwgioikzvobbnfa|hqxvgkwgioikzvobbnfa@gmail.com|hqxvgkwgioikzvobbnfa
ctgdndfcscxeibsjrpla|ctgdndfcscxeibsjrpla@gmail.com|ctgdndfcscxeibsjrpla
hpnalckxszxepwtnyqso|hpnalckxszxepwtnyqso@gmail.com|hpnalckxszxepwtnyqso
lrhdycoqtaajbtuzxnoa|lrhdycoqtaajbtuzxnoa@gmail.com|lrhdycoqtaajbtuzxnoa
nnqooxiahoqpfogcyuog|nnqooxiahoqpfogcyuog@gmail.com|nnqooxiahoqpfogcyuog
eblpwsjdxverpjeherfp|eblpwsjdxverpjeherfp@gmail.com|eblpwsjdxverpjeherfp
ejrlxnddcjeaithddvla|ejrlxnddcjeaithddvla@gmail.com|ejrlxnddcjeaithddvla
xramdieehwrarwrkvrkp|xramdieehwrarwrkvrkp@gmail.com|xramdieehwrarwrkvrkp
nsigksawryaygrrrqtgg|nsigksawryaygrrrqtgg@gmail.com|nsigksawryaygrrrqtgg
iqextjblwfjctsaccbjr|iqextjblwfjctsaccbjr@gmail.com|iqextjblwfjctsaccbjr
jleldjjeupfytpbfqwbf|jleldjjeupfytpbfqwbf@gmail.com|jleldjjeupfytpbfqwbf
skzvvnwwbdthlulrlknj|skzvvnwwbdthlulrlknj@gmail.com|skzvvnwwbdthlulrlknj
yjmznvmscmxwyjyusgrx|yjmznvmscmxwyjyusgrx@gmail.com|yjmznvmscmxwyjyusgrx
ipurfmygypxebcxqaznp|ipurfmygypxebcxqaznp@gmail.com|ipurfmygypxebcxqaznp
xbmkvxfyiizpmnonhcol|xbmkvxfyiizpmnonhcol@gmail.com|xbmkvxfyiizpmnonhcol
mmwiognfifiomosmgszh|mmwiognfifiomosmgszh@gmail.com|mmwiognfifiomosmgszh
gaxalujgjzdkkoalhuqp|gaxalujgjzdkkoalhuqp@gmail.com|gaxalujgjzdkkoalhuqp
vtpqmflsrnuyqufgcosi|vtpqmflsrnuyqufgcosi@gmail.com|vtpqmflsrnuyqufgcosi
jbwgwtxbshkeqbcymcfk|jbwgwtxbshkeqbcymcfk@gmail.com|jbwgwtxbshkeqbcymcfk
uhpbonwqukjsnsrrrxvu|uhpbonwqukjsnsrrrxvu@gmail.com|uhpbonwqukjsnsrrrxvu
eiojrxmumblcynvdhwje|eiojrxmumblcynvdhwje@gmail.com|eiojrxmumblcynvdhwje
vyycvimphknpqoaaqxcx|vyycvimphknpqoaaqxcx@gmail.com|vyycvimphknpqoaaqxcx
iguwhlarojrkzefefnlc|iguwhlarojrkzefefnlc@gmail.com|iguwhlarojrkzefefnlc
fvwboqrbqodfizaosizz|fvwboqrbqodfizaosizz@gmail.com|fvwboqrbqodfizaosizz
xzhbhsiyfzhitvkpzfsp|xzhbhsiyfzhitvkpzfsp@gmail.com|xzhbhsiyfzhitvkpzfsp
xqejjaplhinrruoetwcc|xqejjaplhinrruoetwcc@gmail.com|xqejjaplhinrruoetwcc
zsfnkrfbtfwqfvgoshvn|zsfnkrfbtfwqfvgoshvn@gmail.com|zsfnkrfbtfwqfvgoshvn
eircmaguijyrmornduvv|eircmaguijyrmornduvv@gmail.com|eircmaguijyrmornduvv
cdqmnsmvlsrwvayyahui|cdqmnsmvlsrwvayyahui@gmail.com|cdqmnsmvlsrwvayyahui
vvqumlygaufogokrzyzb|vvqumlygaufogokrzyzb@gmail.com|vvqumlygaufogokrzyzb
quqkzdbensuirortracj|quqkzdbensuirortracj@gmail.com|quqkzdbensuirortracj
iterfhekmeqwckykenoe|iterfhekmeqwckykenoe@gmail.com|iterfhekmeqwckykenoe
mzakvypjsayldtkrvgkj|mzakvypjsayldtkrvgkj@gmail.com|mzakvypjsayldtkrvgkj
bbgqujdqforheqhtflwm|bbgqujdqforheqhtflwm@gmail.com|bbgqujdqforheqhtflwm
ptpgpbbkavifohlmjdxc|ptpgpbbkavifohlmjdxc@gmail.com|ptpgpbbkavifohlmjdxc
domwpcyszilsozyenclv|domwpcyszilsozyenclv@gmail.com|domwpcyszilsozyenclv
anteuavduxfrvxqfetpm|anteuavduxfrvxqfetpm@gmail.com|anteuavduxfrvxqfetpm
gfvhhskblcgomczacgvk|gfvhhskblcgomczacgvk@gmail.com|gfvhhskblcgomczacgvk
ydjabdijhoxasogwdhsy|ydjabdijhoxasogwdhsy@gmail.com|ydjabdijhoxasogwdhsy
zidyveicsoyaeijhwidv|zidyveicsoyaeijhwidv@gmail.com|zidyveicsoyaeijhwidv
pvsozpefdrocbxrydwfm|pvsozpefdrocbxrydwfm@gmail.com|pvsozpefdrocbxrydwfm
bbrlgeguwfdvnitzqljo|bbrlgeguwfdvnitzqljo@gmail.com|bbrlgeguwfdvnitzqljo
qfovdwsdinubblpiofzq|qfovdwsdinubblpiofzq@gmail.com|qfovdwsdinubblpiofzq
pccxhtlqoaononjrcevo|pccxhtlqoaononjrcevo@gmail.com|pccxhtlqoaononjrcevo
tttadlbkwrburbxozsdn|tttadlbkwrburbxozsdn@gmail.com|tttadlbkwrburbxozsdn
baovgzqjsbvafjjxalng|baovgzqjsbvafjjxalng@gmail.com|baovgzqjsbvafjjxalng
rzazopligasqgbmuoeru|rzazopligasqgbmuoeru@gmail.com|rzazopligasqgbmuoeru
yhuuxhvwhkgqxmtcnums|yhuuxhvwhkgqxmtcnums@gmail.com|yhuuxhvwhkgqxmtcnums
ttlhopposszyovcwjudb|ttlhopposszyovcwjudb@gmail.com|ttlhopposszyovcwjudb
sllewcrxrpuwtpwrdirc|sllewcrxrpuwtpwrdirc@gmail.com|sllewcrxrpuwtpwrdirc
knyrdeuhltflfshcwsuy|knyrdeuhltflfshcwsuy@gmail.com|knyrdeuhltflfshcwsuy
phwthkomwuzmtqhbivgi|phwthkomwuzmtqhbivgi@gmail.com|phwthkomwuzmtqhbivgi
wqjouzomkikytiykqmys|wqjouzomkikytiykqmys@gmail.com|wqjouzomkikytiykqmys
kbaogtotdpkttgnrivwh|kbaogtotdpkttgnrivwh@gmail.com|kbaogtotdpkttgnrivwh
rcwteogvcwrmthijtjip|rcwteogvcwrmthijtjip@gmail.com|rcwteogvcwrmthijtjip
pyoshccitkxdmsbanfej|pyoshccitkxdmsbanfej@gmail.com|pyoshccitkxdmsbanfej
spqgwbzioflfsvgrgrgy|spqgwbzioflfsvgrgrgy@gmail.com|spqgwbzioflfsvgrgrgy
rcmfoyyaopmqqfdafdhs|rcmfoyyaopmqqfdafdhs@gmail.com|rcmfoyyaopmqqfdafdhs
bhbjqcmtdyjmpvffgvzv|bhbjqcmtdyjmpvffgvzv@gmail.com|bhbjqcmtdyjmpvffgvzv
vpzjnbjwzasidwqaisxy|vpzjnbjwzasidwqaisxy@gmail.com|vpzjnbjwzasidwqaisxy
vhptpndpykfyscltlklw|vhptpndpykfyscltlklw@gmail.com|vhptpndpykfyscltlklw
swrlpelildtvrwxpbrxy|swrlpelildtvrwxpbrxy@gmail.com|swrlpelildtvrwxpbrxy
mpiqgvflpreivkjwkxpc|mpiqgvflpreivkjwkxpc@gmail.com|mpiqgvflpreivkjwkxpc
hxgfypnnkrumxzrskumx|hxgfypnnkrumxzrskumx@gmail.com|hxgfypnnkrumxzrskumx
gwznwtamydqsalfzwuiz|gwznwtamydqsalfzwuiz@gmail.com|gwznwtamydqsalfzwuiz
taxshggpsfnfpmpmxevw|taxshggpsfnfpmpmxevw@gmail.com|taxshggpsfnfpmpmxevw
wxgonyrklnpctozssoeo|wxgonyrklnpctozssoeo@gmail.com|wxgonyrklnpctozssoeo
vqskdkeaxkntjcxjrnlb|vqskdkeaxkntjcxjrnlb@gmail.com|vqskdkeaxkntjcxjrnlb
rzandvikilxfetivnafj|rzandvikilxfetivnafj@gmail.com|rzandvikilxfetivnafj
znsuqcsuuofjqftbcnnb|znsuqcsuuofjqftbcnnb@gmail.com|znsuqcsuuofjqftbcnnb
qrhuyckmualygighvmjj|qrhuyckmualygighvmjj@gmail.com|qrhuyckmualygighvmjj
xmhprhrbxwbtzfrzzxdk|xmhprhrbxwbtzfrzzxdk@gmail.com|xmhprhrbxwbtzfrzzxdk
esdfmmxnugmfpllraemu|esdfmmxnugmfpllraemu@gmail.com|esdfmmxnugmfpllraemu
ieukmsgqgpbfmxkjhutp|ieukmsgqgpbfmxkjhutp@gmail.com|ieukmsgqgpbfmxkjhutp
pykrherubpvletbobmlv|pykrherubpvletbobmlv@gmail.com|pykrherubpvletbobmlv
cyedrcwqkmlgrkqlxuow|cyedrcwqkmlgrkqlxuow@gmail.com|cyedrcwqkmlgrkqlxuow
bvvoenibwgujvfpagrib|bvvoenibwgujvfpagrib@gmail.com|bvvoenibwgujvfpagrib
yiupeqpzrpfiiakgpjpw|yiupeqpzrpfiiakgpjpw@gmail.com|yiupeqpzrpfiiakgpjpw
vuyezedfprsbmmpqguav|vuyezedfprsbmmpqguav@gmail.com|vuyezedfprsbmmpqguav
iidrhzwslwprrvxinmcu|iidrhzwslwprrvxinmcu@gmail.com|iidrhzwslwprrvxinmcu
ehahcozpxmeevvjstbyy|ehahcozpxmeevvjstbyy@gmail.com|ehahcozpxmeevvjstbyy
uabstqniwmlfvoeygrzi|uabstqniwmlfvoeygrzi@gmail.com|uabstqniwmlfvoeygrzi
lvitntrimuilfkkzzbrd|lvitntrimuilfkkzzbrd@gmail.com|lvitntrimuilfkkzzbrd
qdlvwyejwyqdhxydmvij|qdlvwyejwyqdhxydmvij@gmail.com|qdlvwyejwyqdhxydmvij
ymuikelqaecnryvlgpcw|ymuikelqaecnryvlgpcw@gmail.com|ymuikelqaecnryvlgpcw
ckmhumxlcjycwpwfxneg|ckmhumxlcjycwpwfxneg@gmail.com|ckmhumxlcjycwpwfxneg
uviusrnsjrjrbnjbqdsp|uviusrnsjrjrbnjbqdsp@gmail.com|uviusrnsjrjrbnjbqdsp
xiwhfyhwjwuekbxivxiu|xiwhfyhwjwuekbxivxiu@gmail.com|xiwhfyhwjwuekbxivxiu
bcyeffygmvluovjumdgq|bcyeffygmvluovjumdgq@gmail.com|bcyeffygmvluovjumdgq
wismexhtkwrenyufnczf|wismexhtkwrenyufnczf@gmail.com|wismexhtkwrenyufnczf
bdbqrayxvneiigphzdie|bdbqrayxvneiigphzdie@gmail.com|bdbqrayxvneiigphzdie
gdnhwnfvsfrmgpoozzwj|gdnhwnfvsfrmgpoozzwj@gmail.com|gdnhwnfvsfrmgpoozzwj
hoooggzwhhdkcgusxhwz|hoooggzwhhdkcgusxhwz@gmail.com|hoooggzwhhdkcgusxhwz
aitqxujntkzeetafkhyf|aitqxujntkzeetafkhyf@gmail.com|aitqxujntkzeetafkhyf
znozijusdacwakcgangk|znozijusdacwakcgangk@gmail.com|znozijusdacwakcgangk
apdglgmdreqqdvbnlozn|apdglgmdreqqdvbnlozn@gmail.com|apdglgmdreqqdvbnlozn
wouxnduvcgvihmfriuuq|wouxnduvcgvihmfriuuq@gmail.com|wouxnduvcgvihmfriuuq
jevgmutxkbqexjaokwvb|jevgmutxkbqexjaokwvb@gmail.com|jevgmutxkbqexjaokwvb
rvlkddoccpqjftdckunu|rvlkddoccpqjftdckunu@gmail.com|rvlkddoccpqjftdckunu
qwcpfjftsggukemkdont|qwcpfjftsggukemkdont@gmail.com|qwcpfjftsggukemkdont
yborrsqbbmgadwtvocsk|yborrsqbbmgadwtvocsk@gmail.com|yborrsqbbmgadwtvocsk
safxzsvdbpgrqdovysji|safxzsvdbpgrqdovysji@gmail.com|safxzsvdbpgrqdovysji
dnnaamllaihktzmwxnmg|dnnaamllaihktzmwxnmg@gmail.com|dnnaamllaihktzmwxnmg
uedgkigadhdbdbwuqpwn|uedgkigadhdbdbwuqpwn@gmail.com|uedgkigadhdbdbwuqpwn
fdipbhqvnjffvdphoqct|fdipbhqvnjffvdphoqct@gmail.com|fdipbhqvnjffvdphoqct
vrwhvgvoviyefpmcdoei|vrwhvgvoviyefpmcdoei@gmail.com|vrwhvgvoviyefpmcdoei
xgiwigksnfkjpkyufieo|xgiwigksnfkjpkyufieo@gmail.com|xgiwigksnfkjpkyufieo
hcyojhektcwfmlznhxca|hcyojhektcwfmlznhxca@gmail.com|hcyojhektcwfmlznhxca
wscbjgjozhbgdtphuaco|wscbjgjozhbgdtphuaco@gmail.com|wscbjgjozhbgdtphuaco
sulvwshctcvvlnnjthud|sulvwshctcvvlnnjthud@gmail.com|sulvwshctcvvlnnjthud
opgfzauotjivdkemousi|opgfzauotjivdkemousi@gmail.com|opgfzauotjivdkemousi
pnhrbfzdzydmrrptagih|pnhrbfzdzydmrrptagih@gmail.com|pnhrbfzdzydmrrptagih
esnjlpephgfsthqarieu|esnjlpephgfsthqarieu@gmail.com|esnjlpephgfsthqarieu
glhfwdwqltzsumkxzsbu|glhfwdwqltzsumkxzsbu@gmail.com|glhfwdwqltzsumkxzsbu
cscplbldzkftjozfvhta|cscplbldzkftjozfvhta@gmail.com|cscplbldzkftjozfvhta
gjcucksbsyortbzdamre|gjcucksbsyortbzdamre@gmail.com|gjcucksbsyortbzdamre
jqafzwauwjdjkkldvbil|jqafzwauwjdjkkldvbil@gmail.com|jqafzwauwjdjkkldvbil
ympvudzghzbjnqdbkyou|ympvudzghzbjnqdbkyou@gmail.com|ympvudzghzbjnqdbkyou
gjvhywpyexpsyfofbveg|gjvhywpyexpsyfofbveg@gmail.com|gjvhywpyexpsyfofbveg
ribmuwthtixspqqiggan|ribmuwthtixspqqiggan@gmail.com|ribmuwthtixspqqiggan
cfdullwraxbwwbpajzhj|cfdullwraxbwwbpajzhj@gmail.com|cfdullwraxbwwbpajzhj
iojplxcyzaaadlbrlwva|iojplxcyzaaadlbrlwva@gmail.com|iojplxcyzaaadlbrlwva
gvkshjahrnsygnxjbycq|gvkshjahrnsygnxjbycq@gmail.com|gvkshjahrnsygnxjbycq
istdgtjvlmxtfqmmdzsa|istdgtjvlmxtfqmmdzsa@gmail.com|istdgtjvlmxtfqmmdzsa
nrffcssnizshzxrqbypg|nrffcssnizshzxrqbypg@gmail.com|nrffcssnizshzxrqbypg
iescqrmwtgazdababvlq|iescqrmwtgazdababvlq@gmail.com|iescqrmwtgazdababvlq
pumexinjpesfdrwklpud|pumexinjpesfdrwklpud@gmail.com|pumexinjpesfdrwklpud
wmevvvfsykkkaosworvm|wmevvvfsykkkaosworvm@gmail.com|wmevvvfsykkkaosworvm
njgwnwwaitcwmougromv|njgwnwwaitcwmougromv@gmail.com|njgwnwwaitcwmougromv
gcsqvtlipwnibrsklhwk|gcsqvtlipwnibrsklhwk@gmail.com|gcsqvtlipwnibrsklhwk
upbaiaszgbufscpojdeo|upbaiaszgbufscpojdeo@gmail.com|upbaiaszgbufscpojdeo
rgzgupfgyprndgwdbdzf|rgzgupfgyprndgwdbdzf@gmail.com|rgzgupfgyprndgwdbdzf
rpkjvrvxtanxbvdtfhhn|rpkjvrvxtanxbvdtfhhn@gmail.com|rpkjvrvxtanxbvdtfhhn
gqhqexrvjuymaqlvjgrh|gqhqexrvjuymaqlvjgrh@gmail.com|gqhqexrvjuymaqlvjgrh
sauidovfinnlmgineygf|sauidovfinnlmgineygf@gmail.com|sauidovfinnlmgineygf
wmavokldbdgfgntonubx|wmavokldbdgfgntonubx@gmail.com|wmavokldbdgfgntonubx
tdljginuqcxisxfvfwfn|tdljginuqcxisxfvfwfn@gmail.com|tdljginuqcxisxfvfwfn
ybsanpedvpqkxrauglid|ybsanpedvpqkxrauglid@gmail.com|ybsanpedvpqkxrauglid
pkidoginaqjfkypdlibb|pkidoginaqjfkypdlibb@gmail.com|pkidoginaqjfkypdlibb
lirdligbionilqmxbwkt|lirdligbionilqmxbwkt@gmail.com|lirdligbionilqmxbwkt
zpxqvajvidjzwkmsccni|zpxqvajvidjzwkmsccni@gmail.com|zpxqvajvidjzwkmsccni
okfmszsgdqsztdhbmact|okfmszsgdqsztdhbmact@gmail.com|okfmszsgdqsztdhbmact
hxjacroocaazsdjqhcfa|hxjacroocaazsdjqhcfa@gmail.com|hxjacroocaazsdjqhcfa
kucnvktwetvcxehkzvqb|kucnvktwetvcxehkzvqb@gmail.com|kucnvktwetvcxehkzvqb
excajneousdngngqszep|excajneousdngngqszep@gmail.com|excajneousdngngqszep
klxdkmpldxeyluwupmjv|klxdkmpldxeyluwupmjv@gmail.com|klxdkmpldxeyluwupmjv
yfzomtfrxqbjswxwyrjs|yfzomtfrxqbjswxwyrjs@gmail.com|yfzomtfrxqbjswxwyrjs
plsjrqjfntwsuenarpnq|plsjrqjfntwsuenarpnq@gmail.com|plsjrqjfntwsuenarpnq
bzfuotcxxwgbktdlfqgp|bzfuotcxxwgbktdlfqgp@gmail.com|bzfuotcxxwgbktdlfqgp
onwlxbkradqlssyazzke|onwlxbkradqlssyazzke@gmail.com|onwlxbkradqlssyazzke
flbjurmgefqpxvwrvibb|flbjurmgefqpxvwrvibb@gmail.com|flbjurmgefqpxvwrvibb
bvatnekejtxmrszofdpe|bvatnekejtxmrszofdpe@gmail.com|bvatnekejtxmrszofdpe
mxevfkcucuxmfieiwivv|mxevfkcucuxmfieiwivv@gmail.com|mxevfkcucuxmfieiwivv
znrrstkuxzqovfhqvipi|znrrstkuxzqovfhqvipi@gmail.com|znrrstkuxzqovfhqvipi
zigviteajsvnzskwvavu|zigviteajsvnzskwvavu@gmail.com|zigviteajsvnzskwvavu
itjlldirwegdlnfxmhvl|itjlldirwegdlnfxmhvl@gmail.com|itjlldirwegdlnfxmhvl
fuvvheemypxgkmnenzlt|fuvvheemypxgkmnenzlt@gmail.com|fuvvheemypxgkmnenzlt
lymiqopkknzvngjghduv|lymiqopkknzvngjghduv@gmail.com|lymiqopkknzvngjghduv
dtwqyddiindwgsnjvlpp|dtwqyddiindwgsnjvlpp@gmail.com|dtwqyddiindwgsnjvlpp
qvoqcpqpbfxmxvydmvst|qvoqcpqpbfxmxvydmvst@gmail.com|qvoqcpqpbfxmxvydmvst
spawvxyqpytunxoqpwzu|spawvxyqpytunxoqpwzu@gmail.com|spawvxyqpytunxoqpwzu
aqmlfghumpjjkrhdqljx|aqmlfghumpjjkrhdqljx@gmail.com|aqmlfghumpjjkrhdqljx
itfxmmylkrpjemsghewq|itfxmmylkrpjemsghewq@gmail.com|itfxmmylkrpjemsghewq
seebgcaocdqqnybthvsn|seebgcaocdqqnybthvsn@gmail.com|seebgcaocdqqnybthvsn
pvfumopbpbsdfptqhhng|pvfumopbpbsdfptqhhng@gmail.com|pvfumopbpbsdfptqhhng
xwgevlsldcrfliwkonqa|xwgevlsldcrfliwkonqa@gmail.com|xwgevlsldcrfliwkonqa
nnduljsmfhwgxocaxnbc|nnduljsmfhwgxocaxnbc@gmail.com|nnduljsmfhwgxocaxnbc
uskgtzejgrxvvnznxtvg|uskgtzejgrxvvnznxtvg@gmail.com|uskgtzejgrxvvnznxtvg
cfbymbvpgdysyqzsxcxl|cfbymbvpgdysyqzsxcxl@gmail.com|cfbymbvpgdysyqzsxcxl
yyvbmjfjpsljlttqpjbj|yyvbmjfjpsljlttqpjbj@gmail.com|yyvbmjfjpsljlttqpjbj
cretmjiethiuasycejbt|cretmjiethiuasycejbt@gmail.com|cretmjiethiuasycejbt
cxbdbisymfadeugsewkq|cxbdbisymfadeugsewkq@gmail.com|cxbdbisymfadeugsewkq
gcegiplzmdbgwzydnxoi|gcegiplzmdbgwzydnxoi@gmail.com|gcegiplzmdbgwzydnxoi
wcqhwrdwxevptaxpqvob|wcqhwrdwxevptaxpqvob@gmail.com|wcqhwrdwxevptaxpqvob
fqmpkcjwiniwuanvqbun|fqmpkcjwiniwuanvqbun@gmail.com|fqmpkcjwiniwuanvqbun
tivqhutrdkqjyzengzqz|tivqhutrdkqjyzengzqz@gmail.com|tivqhutrdkqjyzengzqz
qmcqnkcvroabhgmqilin|qmcqnkcvroabhgmqilin@gmail.com|qmcqnkcvroabhgmqilin
jefcagzjcakgnahyjqqv|jefcagzjcakgnahyjqqv@gmail.com|jefcagzjcakgnahyjqqv
gxqqepkhowkakqgsmoou|gxqqepkhowkakqgsmoou@gmail.com|gxqqepkhowkakqgsmoou
yagptsoekkyudcdpccmj|yagptsoekkyudcdpccmj@gmail.com|yagptsoekkyudcdpccmj
kzcukbgodsxuaxnrkpln|kzcukbgodsxuaxnrkpln@gmail.com|kzcukbgodsxuaxnrkpln
nkbaxnyyrsymqvctmcmp|nkbaxnyyrsymqvctmcmp@gmail.com|nkbaxnyyrsymqvctmcmp
cvvlddxeeafreadpkkqd|cvvlddxeeafreadpkkqd@gmail.com|cvvlddxeeafreadpkkqd
juambqzkzkllvqgntlnq|juambqzkzkllvqgntlnq@gmail.com|juambqzkzkllvqgntlnq
uaedwcvnnussklmgwwap|uaedwcvnnussklmgwwap@gmail.com|uaedwcvnnussklmgwwap
ypdrlhyyomdwuhzqjjmc|ypdrlhyyomdwuhzqjjmc@gmail.com|ypdrlhyyomdwuhzqjjmc
atsiuywqtadgmbblkcow|atsiuywqtadgmbblkcow@gmail.com|atsiuywqtadgmbblkcow
mlurztxzsbpoxojfujwj|mlurztxzsbpoxojfujwj@gmail.com|mlurztxzsbpoxojfujwj
vmxlngdbsxmaovrkwqkc|vmxlngdbsxmaovrkwqkc@gmail.com|vmxlngdbsxmaovrkwqkc
jyfujadnkynvlgkvhnho|jyfujadnkynvlgkvhnho@gmail.com|jyfujadnkynvlgkvhnho
gjqrigolljccuwmichzx|gjqrigolljccuwmichzx@gmail.com|gjqrigolljccuwmichzx
tsydmhhbvdlwanacsgse|tsydmhhbvdlwanacsgse@gmail.com|tsydmhhbvdlwanacsgse
jeyhmjfjcicsjaqvljlv|jeyhmjfjcicsjaqvljlv@gmail.com|jeyhmjfjcicsjaqvljlv
zeexsjfzxhtifqtapyba|zeexsjfzxhtifqtapyba@gmail.com|zeexsjfzxhtifqtapyba
pbodxqlxytrxrfnxjbpb|pbodxqlxytrxrfnxjbpb@gmail.com|pbodxqlxytrxrfnxjbpb
ypvxyywtqfypooxszyhv|ypvxyywtqfypooxszyhv@gmail.com|ypvxyywtqfypooxszyhv
qbspakqpkqtbsycisbft|qbspakqpkqtbsycisbft@gmail.com|qbspakqpkqtbsycisbft
grubnwrsmmsrkyjsjzar|grubnwrsmmsrkyjsjzar@gmail.com|grubnwrsmmsrkyjsjzar
gajvqhokecfhxmfnujov|gajvqhokecfhxmfnujov@gmail.com|gajvqhokecfhxmfnujov
lepmsftzblvpyajngomx|lepmsftzblvpyajngomx@gmail.com|lepmsftzblvpyajngomx
pmbviytibfobkxxvqtyg|pmbviytibfobkxxvqtyg@gmail.com|pmbviytibfobkxxvqtyg
shtsapuetbgqzcazsdtd|shtsapuetbgqzcazsdtd@gmail.com|shtsapuetbgqzcazsdtd
opmpbxlzwkjqmbnapogn|opmpbxlzwkjqmbnapogn@gmail.com|opmpbxlzwkjqmbnapogn
ureydbwivjbryzbiihda|ureydbwivjbryzbiihda@gmail.com|ureydbwivjbryzbiihda
wgzeqtktjfycmljavqap|wgzeqtktjfycmljavqap@gmail.com|wgzeqtktjfycmljavqap
nzheenjqdqdppsrjjfji|nzheenjqdqdppsrjjfji@gmail.com|nzheenjqdqdppsrjjfji
gkqolsmjzitmfglkwrmf|gkqolsmjzitmfglkwrmf@gmail.com|gkqolsmjzitmfglkwrmf
gwyrnvmooqdmpsfivlck|gwyrnvmooqdmpsfivlck@gmail.com|gwyrnvmooqdmpsfivlck
kxhbbzxjpyboywzatcux|kxhbbzxjpyboywzatcux@gmail.com|kxhbbzxjpyboywzatcux
vwniksokbbmegqvsyjyn|vwniksokbbmegqvsyjyn@gmail.com|vwniksokbbmegqvsyjyn
fzjekqsnwdyhdtovkire|fzjekqsnwdyhdtovkire@gmail.com|fzjekqsnwdyhdtovkire
hoyrupfokqkqqvegfpwn|hoyrupfokqkqqvegfpwn@gmail.com|hoyrupfokqkqqvegfpwn
pvdaiynjxpxtvksojftf|pvdaiynjxpxtvksojftf@gmail.com|pvdaiynjxpxtvksojftf
wxvarrhzmdzmsqzvykjv|wxvarrhzmdzmsqzvykjv@gmail.com|wxvarrhzmdzmsqzvykjv
otexldkrugifyafkiyxt|otexldkrugifyafkiyxt@gmail.com|otexldkrugifyafkiyxt
dpwevjcoilqhsfketbym|dpwevjcoilqhsfketbym@gmail.com|dpwevjcoilqhsfketbym
njlmjpordbioysveskmy|njlmjpordbioysveskmy@gmail.com|njlmjpordbioysveskmy
crztjktnnnvjhlyhhxqd|crztjktnnnvjhlyhhxqd@gmail.com|crztjktnnnvjhlyhhxqd
fbffxdgbtzejulztwock|fbffxdgbtzejulztwock@gmail.com|fbffxdgbtzejulztwock
fmvdprenkjnldgzjitnw|fmvdprenkjnldgzjitnw@gmail.com|fmvdprenkjnldgzjitnw
tvgnebjfvvotzvwkleit|tvgnebjfvvotzvwkleit@gmail.com|tvgnebjfvvotzvwkleit
rbhhwyirylulecstnzmr|rbhhwyirylulecstnzmr@gmail.com|rbhhwyirylulecstnzmr
wawazssulbeoqyxydrtl|wawazssulbeoqyxydrtl@gmail.com|wawazssulbeoqyxydrtl
quzjpbccpbdhhsihpprt|quzjpbccpbdhhsihpprt@gmail.com|quzjpbccpbdhhsihpprt
bwzigdhaqzkpmxbgufmi|bwzigdhaqzkpmxbgufmi@gmail.com|bwzigdhaqzkpmxbgufmi
jicetffophsskebtbryw|jicetffophsskebtbryw@gmail.com|jicetffophsskebtbryw
yuiiabtpetypagnkknwr|yuiiabtpetypagnkknwr@gmail.com|yuiiabtpetypagnkknwr
icgkvdjruizidyhzxdmf|icgkvdjruizidyhzxdmf@gmail.com|icgkvdjruizidyhzxdmf
doewmtdwfbblnphmhcvd|doewmtdwfbblnphmhcvd@gmail.com|doewmtdwfbblnphmhcvd
fhhxcmutawkkkgfiffaz|fhhxcmutawkkkgfiffaz@gmail.com|fhhxcmutawkkkgfiffaz
naxbhrxawcurjbcyxtso|naxbhrxawcurjbcyxtso@gmail.com|naxbhrxawcurjbcyxtso
vgznlghehgurwozdogjr|vgznlghehgurwozdogjr@gmail.com|vgznlghehgurwozdogjr
sqwddwahhvirlzbarljz|sqwddwahhvirlzbarljz@gmail.com|sqwddwahhvirlzbarljz
vqwmjmuysktxzrnyctja|vqwmjmuysktxzrnyctja@gmail.com|vqwmjmuysktxzrnyctja
nykhfjqhuwkwcvxpssul|nykhfjqhuwkwcvxpssul@gmail.com|nykhfjqhuwkwcvxpssul
lfaigbvunlotuogyvrxm|lfaigbvunlotuogyvrxm@gmail.com|lfaigbvunlotuogyvrxm
fyicmpvzlazmamcctslw|fyicmpvzlazmamcctslw@gmail.com|fyicmpvzlazmamcctslw
tzvrhkwnhnvwsvkysmfr|tzvrhkwnhnvwsvkysmfr@gmail.com|tzvrhkwnhnvwsvkysmfr
gysgxszbmkyowntdgssu|gysgxszbmkyowntdgssu@gmail.com|gysgxszbmkyowntdgssu
sldpksilggqsqqhtcbpn|sldpksilggqsqqhtcbpn@gmail.com|sldpksilggqsqqhtcbpn
abxgkqbdkbidcxegxffd|abxgkqbdkbidcxegxffd@gmail.com|abxgkqbdkbidcxegxffd
qygkbfgvmnnmfvqstoeh|qygkbfgvmnnmfvqstoeh@gmail.com|qygkbfgvmnnmfvqstoeh
lsplflxondevvfcifgrk|lsplflxondevvfcifgrk@gmail.com|lsplflxondevvfcifgrk
lluuhsmorwokukdixrbt|lluuhsmorwokukdixrbt@gmail.com|lluuhsmorwokukdixrbt
yswiibqhwwfclkoqtglq|yswiibqhwwfclkoqtglq@gmail.com|yswiibqhwwfclkoqtglq
dvzraqqflwjznhemdsxs|dvzraqqflwjznhemdsxs@gmail.com|dvzraqqflwjznhemdsxs
vffkaqtfucfefompqhxs|vffkaqtfucfefompqhxs@gmail.com|vffkaqtfucfefompqhxs
eumuepvjxtlcbwfrhcaj|eumuepvjxtlcbwfrhcaj@gmail.com|eumuepvjxtlcbwfrhcaj
axpqcpqxnvdnaiufsdsv|axpqcpqxnvdnaiufsdsv@gmail.com|axpqcpqxnvdnaiufsdsv
ecxrxceqwczwnpkxelyd|ecxrxceqwczwnpkxelyd@gmail.com|ecxrxceqwczwnpkxelyd
tgtykaxrrjxbsjvibxrw|tgtykaxrrjxbsjvibxrw@gmail.com|tgtykaxrrjxbsjvibxrw
raxergkaypucagebpqce|raxergkaypucagebpqce@gmail.com|raxergkaypucagebpqce
yzfxudyamnxsbpjybgse|yzfxudyamnxsbpjybgse@gmail.com|yzfxudyamnxsbpjybgse
uvjyruckizighubmwkdh|uvjyruckizighubmwkdh@gmail.com|uvjyruckizighubmwkdh
grvxfzhjhcfzniwkneca|grvxfzhjhcfzniwkneca@gmail.com|grvxfzhjhcfzniwkneca
vzstfbwyhipemaspltdk|vzstfbwyhipemaspltdk@gmail.com|vzstfbwyhipemaspltdk
sczriiykcmfvdxeyhfrd|sczriiykcmfvdxeyhfrd@gmail.com|sczriiykcmfvdxeyhfrd
gxynonirlbegxarbjivg|gxynonirlbegxarbjivg@gmail.com|gxynonirlbegxarbjivg
yyzvxgqndkukheklchbn|yyzvxgqndkukheklchbn@gmail.com|yyzvxgqndkukheklchbn
ctvlhccbfwfejxadlgte|ctvlhccbfwfejxadlgte@gmail.com|ctvlhccbfwfejxadlgte
dzmenlgornvgrtuovimu|dzmenlgornvgrtuovimu@gmail.com|dzmenlgornvgrtuovimu
mjtquqdhncvgttoemymp|mjtquqdhncvgttoemymp@gmail.com|mjtquqdhncvgttoemymp
aworxebavksddalagnzp|aworxebavksddalagnzp@gmail.com|aworxebavksddalagnzp
hzhdvrkdisxejnnlfujg|hzhdvrkdisxejnnlfujg@gmail.com|hzhdvrkdisxejnnlfujg
cjvlknbygwdmdrlxriyj|cjvlknbygwdmdrlxriyj@gmail.com|cjvlknbygwdmdrlxriyj
vlkomqdrdscfhxojvshb|vlkomqdrdscfhxojvshb@gmail.com|vlkomqdrdscfhxojvshb
afrnlispbhlujxglgnvx|afrnlispbhlujxglgnvx@gmail.com|afrnlispbhlujxglgnvx
sjtlxabcqzmejpgamhsp|sjtlxabcqzmejpgamhsp@gmail.com|sjtlxabcqzmejpgamhsp
aslfohtkvtpqesotqtsp|aslfohtkvtpqesotqtsp@gmail.com|aslfohtkvtpqesotqtsp
qugzrcpgiktltyklwotv|qugzrcpgiktltyklwotv@gmail.com|qugzrcpgiktltyklwotv
tpqbgthbbbxvvcgtbtmp|tpqbgthbbbxvvcgtbtmp@gmail.com|tpqbgthbbbxvvcgtbtmp
xdwnfwobuqvzxyuaqkyl|xdwnfwobuqvzxyuaqkyl@gmail.com|xdwnfwobuqvzxyuaqkyl
zxnbcukuzgdrjxvzdksp|zxnbcukuzgdrjxvzdksp@gmail.com|zxnbcukuzgdrjxvzdksp
eicvurdehupovhgddzco|eicvurdehupovhgddzco@gmail.com|eicvurdehupovhgddzco
yzzguvqynqfhyizjvnxa|yzzguvqynqfhyizjvnxa@gmail.com|yzzguvqynqfhyizjvnxa
jehimxuprraenjvjzyya|jehimxuprraenjvjzyya@gmail.com|jehimxuprraenjvjzyya
efhuytjhbrwjntfurqyp|efhuytjhbrwjntfurqyp@gmail.com|efhuytjhbrwjntfurqyp
xzwpulhblavpayixjcav|xzwpulhblavpayixjcav@gmail.com|xzwpulhblavpayixjcav
hdvqxxfvmvqtilmrwojo|hdvqxxfvmvqtilmrwojo@gmail.com|hdvqxxfvmvqtilmrwojo
ezstqcwomnfswtfxwolb|ezstqcwomnfswtfxwolb@gmail.com|ezstqcwomnfswtfxwolb
aoaribezjriwkildwmyu|aoaribezjriwkildwmyu@gmail.com|aoaribezjriwkildwmyu
qdtajvchmubpyraostlh|qdtajvchmubpyraostlh@gmail.com|qdtajvchmubpyraostlh
fhijuritfsyyqzjhgabn|fhijuritfsyyqzjhgabn@gmail.com|fhijuritfsyyqzjhgabn
hbpoagagxpvpxxstsiee|hbpoagagxpvpxxstsiee@gmail.com|hbpoagagxpvpxxstsiee
nlprimchfvkwktefsaan|nlprimchfvkwktefsaan@gmail.com|nlprimchfvkwktefsaan
hzumevcghwgllffuaagk|hzumevcghwgllffuaagk@gmail.com|hzumevcghwgllffuaagk
zdhpgseayqystgrsuwol|zdhpgseayqystgrsuwol@gmail.com|zdhpgseayqystgrsuwol
emzrlieoqftbxvjeagep|emzrlieoqftbxvjeagep@gmail.com|emzrlieoqftbxvjeagep
ijlaeqxurgbzwtdvuwgj|ijlaeqxurgbzwtdvuwgj@gmail.com|ijlaeqxurgbzwtdvuwgj
tqdyciontqyrwqozyenh|tqdyciontqyrwqozyenh@gmail.com|tqdyciontqyrwqozyenh
sxvbsriwahzwwhaksnug|sxvbsriwahzwwhaksnug@gmail.com|sxvbsriwahzwwhaksnug
cjkxihnwkgzxnjkgdydf|cjkxihnwkgzxnjkgdydf@gmail.com|cjkxihnwkgzxnjkgdydf
vsekyggordfbpyzicszo|vsekyggordfbpyzicszo@gmail.com|vsekyggordfbpyzicszo
gwqogpttncgcfygqrgxb|gwqogpttncgcfygqrgxb@gmail.com|gwqogpttncgcfygqrgxb
amoqxzibikhkcitvckah|amoqxzibikhkcitvckah@gmail.com|amoqxzibikhkcitvckah
jvfcfqcrtxphiyyezeui|jvfcfqcrtxphiyyezeui@gmail.com|jvfcfqcrtxphiyyezeui
rkntslvmbledtrdnqauj|rkntslvmbledtrdnqauj@gmail.com|rkntslvmbledtrdnqauj
pwfiipuporlewzvspyat|pwfiipuporlewzvspyat@gmail.com|pwfiipuporlewzvspyat
kqjzhklkpmichtuycgim|kqjzhklkpmichtuycgim@gmail.com|kqjzhklkpmichtuycgim
qskawvpseeydvrhxkoly|qskawvpseeydvrhxkoly@gmail.com|qskawvpseeydvrhxkoly
qqnnzeltmwidmvqlgmyh|qqnnzeltmwidmvqlgmyh@gmail.com|qqnnzeltmwidmvqlgmyh
lxauenmlprlwnypukmgu|lxauenmlprlwnypukmgu@gmail.com|lxauenmlprlwnypukmgu
uccuvdstpmshwvskvrzr|uccuvdstpmshwvskvrzr@gmail.com|uccuvdstpmshwvskvrzr
eboswzdoyowuhocievjl|eboswzdoyowuhocievjl@gmail.com|eboswzdoyowuhocievjl
bwfaezzcxkvfuscxudnj|bwfaezzcxkvfuscxudnj@gmail.com|bwfaezzcxkvfuscxudnj
emsczguxypuzovoitjhm|emsczguxypuzovoitjhm@gmail.com|emsczguxypuzovoitjhm
hfdwmdlbdpryxvcbbvhb|hfdwmdlbdpryxvcbbvhb@gmail.com|hfdwmdlbdpryxvcbbvhb
glxixcsctegfytduntsr|glxixcsctegfytduntsr@gmail.com|glxixcsctegfytduntsr
bqjhunbujqxicxhdejsa|bqjhunbujqxicxhdejsa@gmail.com|bqjhunbujqxicxhdejsa
gqutmdtiuzjlvphscjpc|gqutmdtiuzjlvphscjpc@gmail.com|gqutmdtiuzjlvphscjpc
fxceokjimieeblypncai|fxceokjimieeblypncai@gmail.com|fxceokjimieeblypncai
kfwjlhxcuupuinkgscjd|kfwjlhxcuupuinkgscjd@gmail.com|kfwjlhxcuupuinkgscjd
brbanvysihqoahiwpzsv|brbanvysihqoahiwpzsv@gmail.com|brbanvysihqoahiwpzsv
sprubbtawdoapdexnwlu|sprubbtawdoapdexnwlu@gmail.com|sprubbtawdoapdexnwlu
ngplcgsslkjyysfweepx|ngplcgsslkjyysfweepx@gmail.com|ngplcgsslkjyysfweepx
cevelqndhbxaorknuett|cevelqndhbxaorknuett@gmail.com|cevelqndhbxaorknuett
ibccqisnujrrsbykarjh|ibccqisnujrrsbykarjh@gmail.com|ibccqisnujrrsbykarjh
poxhqlmnxflprdjlzijv|poxhqlmnxflprdjlzijv@gmail.com|poxhqlmnxflprdjlzijv
lchjasnqwwxrmqrzqcjb|lchjasnqwwxrmqrzqcjb@gmail.com|lchjasnqwwxrmqrzqcjb
voteqjcgpmaruxeowmtx|voteqjcgpmaruxeowmtx@gmail.com|voteqjcgpmaruxeowmtx
shtbqqexywbgmlzfaomd|shtbqqexywbgmlzfaomd@gmail.com|shtbqqexywbgmlzfaomd
jvqkdisyecjgljjkxwqv|jvqkdisyecjgljjkxwqv@gmail.com|jvqkdisyecjgljjkxwqv
sstctknowevtbnwyrqul|sstctknowevtbnwyrqul@gmail.com|sstctknowevtbnwyrqul
rtbizymurzazfukqrhba|rtbizymurzazfukqrhba@gmail.com|rtbizymurzazfukqrhba
zgdqitpypngcqlskqxwd|zgdqitpypngcqlskqxwd@gmail.com|zgdqitpypngcqlskqxwd
oghvvvstlaitgrlovgtv|oghvvvstlaitgrlovgtv@gmail.com|oghvvvstlaitgrlovgtv
obevejrivjesemdhxyia|obevejrivjesemdhxyia@gmail.com|obevejrivjesemdhxyia
nrbmyscwumymbazhowza|nrbmyscwumymbazhowza@gmail.com|nrbmyscwumymbazhowza
dvjymperfdwjwlcvfiet|dvjymperfdwjwlcvfiet@gmail.com|dvjymperfdwjwlcvfiet
pjxgdyavnsxgickaisnd|pjxgdyavnsxgickaisnd@gmail.com|pjxgdyavnsxgickaisnd
xqjcfbiycuhirbuxhfrm|xqjcfbiycuhirbuxhfrm@gmail.com|xqjcfbiycuhirbuxhfrm
yawjlzlttucsoqzkhfuk|yawjlzlttucsoqzkhfuk@gmail.com|yawjlzlttucsoqzkhfuk
wlwpwfbhfwwwvdgnoqxy|wlwpwfbhfwwwvdgnoqxy@gmail.com|wlwpwfbhfwwwvdgnoqxy
mykfmuabslcdeezouaib|mykfmuabslcdeezouaib@gmail.com|mykfmuabslcdeezouaib
lwaibbzeiivkbkfbvbtc|lwaibbzeiivkbkfbvbtc@gmail.com|lwaibbzeiivkbkfbvbtc
crhfaohxdemuhuvqwwdd|crhfaohxdemuhuvqwwdd@gmail.com|crhfaohxdemuhuvqwwdd
xjgpdkhrnkzacnwltfog|xjgpdkhrnkzacnwltfog@gmail.com|xjgpdkhrnkzacnwltfog
lauytuijqcpptyarjdje|lauytuijqcpptyarjdje@gmail.com|lauytuijqcpptyarjdje
nhaoeqhgrvhwsztcwjek|nhaoeqhgrvhwsztcwjek@gmail.com|nhaoeqhgrvhwsztcwjek
kprfabumvuyoecwytbnp|kprfabumvuyoecwytbnp@gmail.com|kprfabumvuyoecwytbnp
cigbmcpbsgnuqyqvmlqy|cigbmcpbsgnuqyqvmlqy@gmail.com|cigbmcpbsgnuqyqvmlqy
kgvlvffzmcmklyidehpd|kgvlvffzmcmklyidehpd@gmail.com|kgvlvffzmcmklyidehpd
hacwbxamzptmrlpgnkrs|hacwbxamzptmrlpgnkrs@gmail.com|hacwbxamzptmrlpgnkrs
chfnejlxdytxfpwivflt|chfnejlxdytxfpwivflt@gmail.com|chfnejlxdytxfpwivflt
ehnrhsdcndoqpqtsxftb|ehnrhsdcndoqpqtsxftb@gmail.com|ehnrhsdcndoqpqtsxftb
wkpbvewcsawmiohoczpb|wkpbvewcsawmiohoczpb@gmail.com|wkpbvewcsawmiohoczpb
aeicaskqcgfsauafsciq|aeicaskqcgfsauafsciq@gmail.com|aeicaskqcgfsauafsciq
mmqvdimepqkpjbclhdzr|mmqvdimepqkpjbclhdzr@gmail.com|mmqvdimepqkpjbclhdzr
aezygzopljiogpeenvbf|aezygzopljiogpeenvbf@gmail.com|aezygzopljiogpeenvbf
pyvhppnnltafqfcuhrog|pyvhppnnltafqfcuhrog@gmail.com|pyvhppnnltafqfcuhrog
qvshxeynjrcbpisyacxc|qvshxeynjrcbpisyacxc@gmail.com|qvshxeynjrcbpisyacxc
pqigyzehdajogizhdqmy|pqigyzehdajogizhdqmy@gmail.com|pqigyzehdajogizhdqmy
vmhxgnnfszdduqwgooej|vmhxgnnfszdduqwgooej@gmail.com|vmhxgnnfszdduqwgooej
ciykfoarptqdbrmvutts|ciykfoarptqdbrmvutts@gmail.com|ciykfoarptqdbrmvutts
iqqlljyprzvkxvwflojb|iqqlljyprzvkxvwflojb@gmail.com|iqqlljyprzvkxvwflojb
dqpcpznquhllimxubzlp|dqpcpznquhllimxubzlp@gmail.com|dqpcpznquhllimxubzlp
oevyxgzxelghujxlexlk|oevyxgzxelghujxlexlk@gmail.com|oevyxgzxelghujxlexlk
ohtgrttfhzwrywsjyvta|ohtgrttfhzwrywsjyvta@gmail.com|ohtgrttfhzwrywsjyvta
qxavnnnejjzdoytqbggl|qxavnnnejjzdoytqbggl@gmail.com|qxavnnnejjzdoytqbggl
prvsyxicdajppipxrnar|prvsyxicdajppipxrnar@gmail.com|prvsyxicdajppipxrnar
zirjpbkroeenufxqnkqy|zirjpbkroeenufxqnkqy@gmail.com|zirjpbkroeenufxqnkqy
agizvwylovvpvpsovvio|agizvwylovvpvpsovvio@gmail.com|agizvwylovvpvpsovvio
uiopcitoufaaiyldjpuy|uiopcitoufaaiyldjpuy@gmail.com|uiopcitoufaaiyldjpuy
mdcfftkwucaaypznhvta|mdcfftkwucaaypznhvta@gmail.com|mdcfftkwucaaypznhvta
cuuiazfvcscsvcpmjcza|cuuiazfvcscsvcpmjcza@gmail.com|cuuiazfvcscsvcpmjcza
jwsygzrchvzdhhqoqtwe|jwsygzrchvzdhhqoqtwe@gmail.com|jwsygzrchvzdhhqoqtwe
wcucfvvskfxptxqrbfbr|wcucfvvskfxptxqrbfbr@gmail.com|wcucfvvskfxptxqrbfbr
jbbrkqpcwuahxpymqkcl|jbbrkqpcwuahxpymqkcl@gmail.com|jbbrkqpcwuahxpymqkcl
mvaosbetvgnjsmsotllb|mvaosbetvgnjsmsotllb@gmail.com|mvaosbetvgnjsmsotllb
leoawzwkmrrlrodbmfkz|leoawzwkmrrlrodbmfkz@gmail.com|leoawzwkmrrlrodbmfkz
igajiijdfwvzlaqhdjhs|igajiijdfwvzlaqhdjhs@gmail.com|igajiijdfwvzlaqhdjhs
kzvrbhvzouzhjblgrrjh|kzvrbhvzouzhjblgrrjh@gmail.com|kzvrbhvzouzhjblgrrjh
zwignimiaydfpfwqxgdl|zwignimiaydfpfwqxgdl@gmail.com|zwignimiaydfpfwqxgdl
xlgcoizhutujxsgpiqvo|xlgcoizhutujxsgpiqvo@gmail.com|xlgcoizhutujxsgpiqvo
vqarqbqsafeinbtkltkm|vqarqbqsafeinbtkltkm@gmail.com|vqarqbqsafeinbtkltkm
ijoouhflbsfysvqphrih|ijoouhflbsfysvqphrih@gmail.com|ijoouhflbsfysvqphrih
bmrqyiobmprcseglzouz|bmrqyiobmprcseglzouz@gmail.com|bmrqyiobmprcseglzouz
zccedhsthmlamibayqss|zccedhsthmlamibayqss@gmail.com|zccedhsthmlamibayqss
tgmmullyuodgdveflnls|tgmmullyuodgdveflnls@gmail.com|tgmmullyuodgdveflnls
njuxaxnglvyehvrrbmqz|njuxaxnglvyehvrrbmqz@gmail.com|njuxaxnglvyehvrrbmqz
fqbuikkjlxdpzdukjbzk|fqbuikkjlxdpzdukjbzk@gmail.com|fqbuikkjlxdpzdukjbzk
ozuybhusjfirwpljfovh|ozuybhusjfirwpljfovh@gmail.com|ozuybhusjfirwpljfovh
tinngqyahrnobdjxvnbx|tinngqyahrnobdjxvnbx@gmail.com|tinngqyahrnobdjxvnbx
lsyptaqesjartxczsnmk|lsyptaqesjartxczsnmk@gmail.com|lsyptaqesjartxczsnmk
uajfbnmdyzagnmfbnyfe|uajfbnmdyzagnmfbnyfe@gmail.com|uajfbnmdyzagnmfbnyfe
xgxasusuckajyssrnwvg|xgxasusuckajyssrnwvg@gmail.com|xgxasusuckajyssrnwvg
adkjilmwmzukcxwyidws|adkjilmwmzukcxwyidws@gmail.com|adkjilmwmzukcxwyidws
anmceeypbzgradidklnc|anmceeypbzgradidklnc@gmail.com|anmceeypbzgradidklnc
igdfzeseuqxrstiaoqhb|igdfzeseuqxrstiaoqhb@gmail.com|igdfzeseuqxrstiaoqhb
lbasdkhfifkmcdfkifza|lbasdkhfifkmcdfkifza@gmail.com|lbasdkhfifkmcdfkifza
lxgldcalzlvcmyemrhpk|lxgldcalzlvcmyemrhpk@gmail.com|lxgldcalzlvcmyemrhpk
wjttxnkmjifzftgfxhhv|wjttxnkmjifzftgfxhhv@gmail.com|wjttxnkmjifzftgfxhhv
jptgalezlexoculstgdh|jptgalezlexoculstgdh@gmail.com|jptgalezlexoculstgdh
qbtosagfaeqawmphosny|qbtosagfaeqawmphosny@gmail.com|qbtosagfaeqawmphosny
xosejiosijylebvzujky|xosejiosijylebvzujky@gmail.com|xosejiosijylebvzujky
bixhpzzmufseyrjjqurx|bixhpzzmufseyrjjqurx@gmail.com|bixhpzzmufseyrjjqurx
vvoqdviwduvoybngrnyp|vvoqdviwduvoybngrnyp@gmail.com|vvoqdviwduvoybngrnyp
aggjgsrutsufndkegdzr|aggjgsrutsufndkegdzr@gmail.com|aggjgsrutsufndkegdzr
zovmlrvrentczazvlgue|zovmlrvrentczazvlgue@gmail.com|zovmlrvrentczazvlgue
weyrapxwqjizonbxzjst|weyrapxwqjizonbxzjst@gmail.com|weyrapxwqjizonbxzjst
xwgwybaoruzkncxwrswi|xwgwybaoruzkncxwrswi@gmail.com|xwgwybaoruzkncxwrswi
pnsrefalnhcukyqeviyx|pnsrefalnhcukyqeviyx@gmail.com|pnsrefalnhcukyqeviyx
updngzycrkjdkdkpkhia|updngzycrkjdkdkpkhia@gmail.com|updngzycrkjdkdkpkhia
iiqsxcwhmqlvrjbjsnkk|iiqsxcwhmqlvrjbjsnkk@gmail.com|iiqsxcwhmqlvrjbjsnkk
cayiobuqquoapsnbzjwr|cayiobuqquoapsnbzjwr@gmail.com|cayiobuqquoapsnbzjwr
brhgwkovevwcmlyzhgaf|brhgwkovevwcmlyzhgaf@gmail.com|brhgwkovevwcmlyzhgaf
cusownfvgrhgbheajqmv|cusownfvgrhgbheajqmv@gmail.com|cusownfvgrhgbheajqmv
dxxjhtpmsucqbpqsbnaa|dxxjhtpmsucqbpqsbnaa@gmail.com|dxxjhtpmsucqbpqsbnaa
gjcvfostyfnbsxooljoj|gjcvfostyfnbsxooljoj@gmail.com|gjcvfostyfnbsxooljoj
yoscaxcqripfggjjkdkq|yoscaxcqripfggjjkdkq@gmail.com|yoscaxcqripfggjjkdkq
ejmzucnxujgfrtunywws|ejmzucnxujgfrtunywws@gmail.com|ejmzucnxujgfrtunywws
cdbywigxuhnanimopggy|cdbywigxuhnanimopggy@gmail.com|cdbywigxuhnanimopggy
pykrnfegrujoflxklzla|pykrnfegrujoflxklzla@gmail.com|pykrnfegrujoflxklzla
chvzuojcfyjhspcyoxhf|chvzuojcfyjhspcyoxhf@gmail.com|chvzuojcfyjhspcyoxhf
hxfqhzqvcokfwaoxzwau|hxfqhzqvcokfwaoxzwau@gmail.com|hxfqhzqvcokfwaoxzwau
gfmpgozokvgotoobhxie|gfmpgozokvgotoobhxie@gmail.com|gfmpgozokvgotoobhxie
hiwnbbxwgbofqjyptecy|hiwnbbxwgbofqjyptecy@gmail.com|hiwnbbxwgbofqjyptecy
fomlmhhgapocbmwpuxhf|fomlmhhgapocbmwpuxhf@gmail.com|fomlmhhgapocbmwpuxhf
myaadxgspbjlohroqlas|myaadxgspbjlohroqlas@gmail.com|myaadxgspbjlohroqlas
pnakxbniticolskdglld|pnakxbniticolskdglld@gmail.com|pnakxbniticolskdglld
cdcwjhmexjwwzemthrzj|cdcwjhmexjwwzemthrzj@gmail.com|cdcwjhmexjwwzemthrzj
ffjjmssldobinlxjrdtn|ffjjmssldobinlxjrdtn@gmail.com|ffjjmssldobinlxjrdtn
ulclxhkssikbhfcdnjit|ulclxhkssikbhfcdnjit@gmail.com|ulclxhkssikbhfcdnjit
xqecpgibedjmowtghwbg|xqecpgibedjmowtghwbg@gmail.com|xqecpgibedjmowtghwbg
omfxxriyleomldvliqru|omfxxriyleomldvliqru@gmail.com|omfxxriyleomldvliqru
dfnkckisfyucnqgkdock|dfnkckisfyucnqgkdock@gmail.com|dfnkckisfyucnqgkdock
quevoyelddvmndgyjfcn|quevoyelddvmndgyjfcn@gmail.com|quevoyelddvmndgyjfcn
hoayfrcjpuncdaabbnkn|hoayfrcjpuncdaabbnkn@gmail.com|hoayfrcjpuncdaabbnkn
ioagrkiukikbhkdzxhuw|ioagrkiukikbhkdzxhuw@gmail.com|ioagrkiukikbhkdzxhuw
drllcewyqwcmzymlwgbn|drllcewyqwcmzymlwgbn@gmail.com|drllcewyqwcmzymlwgbn
aqabkxvbkkkwhwcnuwul|aqabkxvbkkkwhwcnuwul@gmail.com|aqabkxvbkkkwhwcnuwul
lkpckqwyfhgeawjspmyc|lkpckqwyfhgeawjspmyc@gmail.com|lkpckqwyfhgeawjspmyc
beotwpiokjcsxrjfjltv|beotwpiokjcsxrjfjltv@gmail.com|beotwpiokjcsxrjfjltv
cvcjpanneyhabnvzljcv|cvcjpanneyhabnvzljcv@gmail.com|cvcjpanneyhabnvzljcv
aoslpaevgrvytnozryvc|aoslpaevgrvytnozryvc@gmail.com|aoslpaevgrvytnozryvc
zkzlbntysucjzhwexjlj|zkzlbntysucjzhwexjlj@gmail.com|zkzlbntysucjzhwexjlj
shadvhkmroonoqzfyczk|shadvhkmroonoqzfyczk@gmail.com|shadvhkmroonoqzfyczk
mglptynvctpyaacrdxxe|mglptynvctpyaacrdxxe@gmail.com|mglptynvctpyaacrdxxe
wtoiumabjyfcbqwhoumj|wtoiumabjyfcbqwhoumj@gmail.com|wtoiumabjyfcbqwhoumj
lmzriobwrmppwiyyjcpl|lmzriobwrmppwiyyjcpl@gmail.com|lmzriobwrmppwiyyjcpl
kprgamjhuvvzscimjykg|kprgamjhuvvzscimjykg@gmail.com|kprgamjhuvvzscimjykg
vdhxtccmrpoxxlkwuodn|vdhxtccmrpoxxlkwuodn@gmail.com|vdhxtccmrpoxxlkwuodn
amipmujvgesiqnvlazqy|amipmujvgesiqnvlazqy@gmail.com|amipmujvgesiqnvlazqy
rycvamcoxmvthmbmocwv|rycvamcoxmvthmbmocwv@gmail.com|rycvamcoxmvthmbmocwv
tuesiyahxtkijioruwvv|tuesiyahxtkijioruwvv@gmail.com|tuesiyahxtkijioruwvv
cdlbyfbrnbvhkhshlcqz|cdlbyfbrnbvhkhshlcqz@gmail.com|cdlbyfbrnbvhkhshlcqz
oshnesxvqjwwcfvttuam|oshnesxvqjwwcfvttuam@gmail.com|oshnesxvqjwwcfvttuam
ngyekfiycsckxfjmsxvk|ngyekfiycsckxfjmsxvk@gmail.com|ngyekfiycsckxfjmsxvk
tczjbyppmveyieqeqfak|tczjbyppmveyieqeqfak@gmail.com|tczjbyppmveyieqeqfak
ylqwgacxyxquotqdwwdi|ylqwgacxyxquotqdwwdi@gmail.com|ylqwgacxyxquotqdwwdi
hfmfvbdqftfifnxudqnk|hfmfvbdqftfifnxudqnk@gmail.com|hfmfvbdqftfifnxudqnk
zkmkifwmpsbdpsbufjnc|zkmkifwmpsbdpsbufjnc@gmail.com|zkmkifwmpsbdpsbufjnc
ihoclnyttyydqhbphkfh|ihoclnyttyydqhbphkfh@gmail.com|ihoclnyttyydqhbphkfh
vgmyjbcykbkygatewnci|vgmyjbcykbkygatewnci@gmail.com|vgmyjbcykbkygatewnci
yaykiupnhxsdtlpvfouh|yaykiupnhxsdtlpvfouh@gmail.com|yaykiupnhxsdtlpvfouh
bztjfawhiiwknkiplsod|bztjfawhiiwknkiplsod@gmail.com|bztjfawhiiwknkiplsod
cyikrcemdqsrnkpeduny|cyikrcemdqsrnkpeduny@gmail.com|cyikrcemdqsrnkpeduny
solakccnxhbwgdvstpwz|solakccnxhbwgdvstpwz@gmail.com|solakccnxhbwgdvstpwz
jeciqqlewsqncnaatjcu|jeciqqlewsqncnaatjcu@gmail.com|jeciqqlewsqncnaatjcu
tnfmztdqxqiyltbjmcoq|tnfmztdqxqiyltbjmcoq@gmail.com|tnfmztdqxqiyltbjmcoq
ewzzdowphackavshalpk|ewzzdowphackavshalpk@gmail.com|ewzzdowphackavshalpk
libmisgtpeqeyfeeapqc|libmisgtpeqeyfeeapqc@gmail.com|libmisgtpeqeyfeeapqc
pgsgebxgqtvtqmmmwewv|pgsgebxgqtvtqmmmwewv@gmail.com|pgsgebxgqtvtqmmmwewv
jcwdtmqyiumncsoeamhf|jcwdtmqyiumncsoeamhf@gmail.com|jcwdtmqyiumncsoeamhf
lsctjfryztkheiggcwmj|lsctjfryztkheiggcwmj@gmail.com|lsctjfryztkheiggcwmj
qgfhkcvkuwpzvwqadfxx|qgfhkcvkuwpzvwqadfxx@gmail.com|qgfhkcvkuwpzvwqadfxx
fyjukmixneckzcbydpfr|fyjukmixneckzcbydpfr@gmail.com|fyjukmixneckzcbydpfr
wggoscrodvmjqypdevgi|wggoscrodvmjqypdevgi@gmail.com|wggoscrodvmjqypdevgi
fqjmdzdbiwwtxrlzpldi|fqjmdzdbiwwtxrlzpldi@gmail.com|fqjmdzdbiwwtxrlzpldi
wwhhebwbqavqwzqrwufk|wwhhebwbqavqwzqrwufk@gmail.com|wwhhebwbqavqwzqrwufk
vulhxskkwivnqdvrvbjk|vulhxskkwivnqdvrvbjk@gmail.com|vulhxskkwivnqdvrvbjk
gtuuwipbksonfnqictdx|gtuuwipbksonfnqictdx@gmail.com|gtuuwipbksonfnqictdx
smoechozomtsjkvlfppd|smoechozomtsjkvlfppd@gmail.com|smoechozomtsjkvlfppd
sqwrikbeesutgdnmnaus|sqwrikbeesutgdnmnaus@gmail.com|sqwrikbeesutgdnmnaus
zmqanlqeavfqojoreiue|zmqanlqeavfqojoreiue@gmail.com|zmqanlqeavfqojoreiue
afxboeexjzayehqdyzhf|afxboeexjzayehqdyzhf@gmail.com|afxboeexjzayehqdyzhf
xhmyurglanbnebfegnwy|xhmyurglanbnebfegnwy@gmail.com|xhmyurglanbnebfegnwy
ynsabplaotrzlyqrrbem|ynsabplaotrzlyqrrbem@gmail.com|ynsabplaotrzlyqrrbem
qswrlwdeirlqyduguwry|qswrlwdeirlqyduguwry@gmail.com|qswrlwdeirlqyduguwry
ecypvjztmrkchwpotonh|ecypvjztmrkchwpotonh@gmail.com|ecypvjztmrkchwpotonh
peuhvygcfpparsginesa|peuhvygcfpparsginesa@gmail.com|peuhvygcfpparsginesa
qqomwbidrxzcdqjxuotl|qqomwbidrxzcdqjxuotl@gmail.com|qqomwbidrxzcdqjxuotl
rfddnhnejohywwpfehfv|rfddnhnejohywwpfehfv@gmail.com|rfddnhnejohywwpfehfv
pbobrrrvjsvhxzyizqxw|pbobrrrvjsvhxzyizqxw@gmail.com|pbobrrrvjsvhxzyizqxw
wkdabevalhwrbovgcili|wkdabevalhwrbovgcili@gmail.com|wkdabevalhwrbovgcili
frpjwjxfqejjztlcsduo|frpjwjxfqejjztlcsduo@gmail.com|frpjwjxfqejjztlcsduo
cqtlolxwobzrfyfcpsvo|cqtlolxwobzrfyfcpsvo@gmail.com|cqtlolxwobzrfyfcpsvo
gslrtifrjpmrrkysyibu|gslrtifrjpmrrkysyibu@gmail.com|gslrtifrjpmrrkysyibu
bodhomtmrwbvrkbdjyhq|bodhomtmrwbvrkbdjyhq@gmail.com|bodhomtmrwbvrkbdjyhq
cdhkqpcmmborlkeylpcd|cdhkqpcmmborlkeylpcd@gmail.com|cdhkqpcmmborlkeylpcd
mysyushljvtnwassbdjs|mysyushljvtnwassbdjs@gmail.com|mysyushljvtnwassbdjs
nfuixgzjyqeugfljmhia|nfuixgzjyqeugfljmhia@gmail.com|nfuixgzjyqeugfljmhia
rgnvqwkppfuwjnivrqjg|rgnvqwkppfuwjnivrqjg@gmail.com|rgnvqwkppfuwjnivrqjg
rdwgoeuuhqaeftvsrtca|rdwgoeuuhqaeftvsrtca@gmail.com|rdwgoeuuhqaeftvsrtca
wvedmlbqzysptlouxero|wvedmlbqzysptlouxero@gmail.com|wvedmlbqzysptlouxero
endbtujmzofjcxpbgtye|endbtujmzofjcxpbgtye@gmail.com|endbtujmzofjcxpbgtye
bnvsqdynoxhnlmxdedxf|bnvsqdynoxhnlmxdedxf@gmail.com|bnvsqdynoxhnlmxdedxf
hgxuykceqzbzxtcajaet|hgxuykceqzbzxtcajaet@gmail.com|hgxuykceqzbzxtcajaet
rwyrpyqotgqlsbtxinew|rwyrpyqotgqlsbtxinew@gmail.com|rwyrpyqotgqlsbtxinew
dkwqhnfuqtfpboeshtjb|dkwqhnfuqtfpboeshtjb@gmail.com|dkwqhnfuqtfpboeshtjb
kpdwiynzzoznitosrveh|kpdwiynzzoznitosrveh@gmail.com|kpdwiynzzoznitosrveh
dhzfwxnwrkvvswyipene|dhzfwxnwrkvvswyipene@gmail.com|dhzfwxnwrkvvswyipene
hrtdwcyeapmxfzpukmlg|hrtdwcyeapmxfzpukmlg@gmail.com|hrtdwcyeapmxfzpukmlg
wmyuwxdejsguqkvloqor|wmyuwxdejsguqkvloqor@gmail.com|wmyuwxdejsguqkvloqor
dfhqlpkotxoealygeypf|dfhqlpkotxoealygeypf@gmail.com|dfhqlpkotxoealygeypf
orsnxleuirkowoyclwiw|orsnxleuirkowoyclwiw@gmail.com|orsnxleuirkowoyclwiw
cryyfhvrdmoseckcvblq|cryyfhvrdmoseckcvblq@gmail.com|cryyfhvrdmoseckcvblq
frmgzxzdbtmbhkghnkcs|frmgzxzdbtmbhkghnkcs@gmail.com|frmgzxzdbtmbhkghnkcs
hvzzhihdxrwventjhvcl|hvzzhihdxrwventjhvcl@gmail.com|hvzzhihdxrwventjhvcl
mzqvqwgmrdgftxrckoqa|mzqvqwgmrdgftxrckoqa@gmail.com|mzqvqwgmrdgftxrckoqa
xkdgczgrknatmsxocppd|xkdgczgrknatmsxocppd@gmail.com|xkdgczgrknatmsxocppd
tjalgndivatwwivlwpas|tjalgndivatwwivlwpas@gmail.com|tjalgndivatwwivlwpas
oeezwubkvkqsywxcjaep|oeezwubkvkqsywxcjaep@gmail.com|oeezwubkvkqsywxcjaep
fyrkenazdvfquhnyqfyd|fyrkenazdvfquhnyqfyd@gmail.com|fyrkenazdvfquhnyqfyd
uutzcheoiilhdgjuubgd|uutzcheoiilhdgjuubgd@gmail.com|uutzcheoiilhdgjuubgd
lfochkkqpmpmebwogycy|lfochkkqpmpmebwogycy@gmail.com|lfochkkqpmpmebwogycy
tttsudriqzwclnxfevac|tttsudriqzwclnxfevac@gmail.com|tttsudriqzwclnxfevac
mvsjgcyhnfqabidpnnvr|mvsjgcyhnfqabidpnnvr@gmail.com|mvsjgcyhnfqabidpnnvr
lenxqiajpjhrxiulmqpo|lenxqiajpjhrxiulmqpo@gmail.com|lenxqiajpjhrxiulmqpo
uxgzymliszsfsstwbfmd|uxgzymliszsfsstwbfmd@gmail.com|uxgzymliszsfsstwbfmd
dygzlfnkvmsdurnudbvg|dygzlfnkvmsdurnudbvg@gmail.com|dygzlfnkvmsdurnudbvg
tzpkynlvrcwjldwjdcmc|tzpkynlvrcwjldwjdcmc@gmail.com|tzpkynlvrcwjldwjdcmc
ynikuckpaofdbiueopzb|ynikuckpaofdbiueopzb@gmail.com|ynikuckpaofdbiueopzb
bccohahrnnnuiflmsseo|bccohahrnnnuiflmsseo@gmail.com|bccohahrnnnuiflmsseo
riqalfhkrrlndawdkuzm|riqalfhkrrlndawdkuzm@gmail.com|riqalfhkrrlndawdkuzm
fnvdhzrhcslzladwankj|fnvdhzrhcslzladwankj@gmail.com|fnvdhzrhcslzladwankj
yqgtglzbyzbjurpcpgue|yqgtglzbyzbjurpcpgue@gmail.com|yqgtglzbyzbjurpcpgue
vlmtygcldpleurxsxstg|vlmtygcldpleurxsxstg@gmail.com|vlmtygcldpleurxsxstg
lcrmsgphpkhifqzslond|lcrmsgphpkhifqzslond@gmail.com|lcrmsgphpkhifqzslond
loshqpphezhewvkzybrs|loshqpphezhewvkzybrs@gmail.com|loshqpphezhewvkzybrs
nbimcihnnizqojhrhzba|nbimcihnnizqojhrhzba@gmail.com|nbimcihnnizqojhrhzba
sgdwfsdsxzzmcbietzdq|sgdwfsdsxzzmcbietzdq@gmail.com|sgdwfsdsxzzmcbietzdq
dlbatyhvmwfcbthsxuiw|dlbatyhvmwfcbthsxuiw@gmail.com|dlbatyhvmwfcbthsxuiw
whhfrobfrmddfrfrrtch|whhfrobfrmddfrfrrtch@gmail.com|whhfrobfrmddfrfrrtch
wdunqhntsttrjzsjrspa|wdunqhntsttrjzsjrspa@gmail.com|wdunqhntsttrjzsjrspa
xahrctzkzynxopvajngh|xahrctzkzynxopvajngh@gmail.com|xahrctzkzynxopvajngh
xkclocrixjkjbxwsnrqy|xkclocrixjkjbxwsnrqy@gmail.com|xkclocrixjkjbxwsnrqy
ylfdfjrbquuesztcjnhz|ylfdfjrbquuesztcjnhz@gmail.com|ylfdfjrbquuesztcjnhz
hwcnvpqezqpmdlcgancm|hwcnvpqezqpmdlcgancm@gmail.com|hwcnvpqezqpmdlcgancm
fwyugomwyighifqljiwr|fwyugomwyighifqljiwr@gmail.com|fwyugomwyighifqljiwr
miydphmljpyfnwjvlgkd|miydphmljpyfnwjvlgkd@gmail.com|miydphmljpyfnwjvlgkd
jsztvswkcrpclujoomay|jsztvswkcrpclujoomay@gmail.com|jsztvswkcrpclujoomay
dbfwtfbohytaoypxbwen|dbfwtfbohytaoypxbwen@gmail.com|dbfwtfbohytaoypxbwen
txrwroigdwdcazfkcyoa|txrwroigdwdcazfkcyoa@gmail.com|txrwroigdwdcazfkcyoa
akhcxpoonelpdrmyjvfu|akhcxpoonelpdrmyjvfu@gmail.com|akhcxpoonelpdrmyjvfu
fimuppqzkqwqoocedeih|fimuppqzkqwqoocedeih@gmail.com|fimuppqzkqwqoocedeih
nklvxucjmbpiexkjoviz|nklvxucjmbpiexkjoviz@gmail.com|nklvxucjmbpiexkjoviz
hmnjodatcgbagvwxunjs|hmnjodatcgbagvwxunjs@gmail.com|hmnjodatcgbagvwxunjs
csemoceezxqeeazpycul|csemoceezxqeeazpycul@gmail.com|csemoceezxqeeazpycul
rfhklubnvdmcpoxzutyv|rfhklubnvdmcpoxzutyv@gmail.com|rfhklubnvdmcpoxzutyv
vutwhtddqmeagfmvoyse|vutwhtddqmeagfmvoyse@gmail.com|vutwhtddqmeagfmvoyse
jxlccdhilhuokouedjvm|jxlccdhilhuokouedjvm@gmail.com|jxlccdhilhuokouedjvm
pxxgurwbwcwsbtikaifj|pxxgurwbwcwsbtikaifj@gmail.com|pxxgurwbwcwsbtikaifj
mmeeftggmjxpqpqeaeox|mmeeftggmjxpqpqeaeox@gmail.com|mmeeftggmjxpqpqeaeox
fshgveykfgqvasmtvwxn|fshgveykfgqvasmtvwxn@gmail.com|fshgveykfgqvasmtvwxn
wdnucraihbfepituxcyi|wdnucraihbfepituxcyi@gmail.com|wdnucraihbfepituxcyi
qbeqawtzvdztlctsdhqy|qbeqawtzvdztlctsdhqy@gmail.com|qbeqawtzvdztlctsdhqy
vwnudaaxgrsvjrfepkqc|vwnudaaxgrsvjrfepkqc@gmail.com|vwnudaaxgrsvjrfepkqc
tyqjcbhccaiuuixumrhx|tyqjcbhccaiuuixumrhx@gmail.com|tyqjcbhccaiuuixumrhx
doytzziqctrwvxewaxwh|doytzziqctrwvxewaxwh@gmail.com|doytzziqctrwvxewaxwh
kysxekglfzakrbjfjatf|kysxekglfzakrbjfjatf@gmail.com|kysxekglfzakrbjfjatf
oyyofpeiclfqyzqofnaz|oyyofpeiclfqyzqofnaz@gmail.com|oyyofpeiclfqyzqofnaz
gmruadhytrijwatpxogu|gmruadhytrijwatpxogu@gmail.com|gmruadhytrijwatpxogu
eehqdqgsrtgzgjynijfr|eehqdqgsrtgzgjynijfr@gmail.com|eehqdqgsrtgzgjynijfr
pkhcgjwnznogaruwadtd|pkhcgjwnznogaruwadtd@gmail.com|pkhcgjwnznogaruwadtd
lvakdsrwsdggdklvwhuo|lvakdsrwsdggdklvwhuo@gmail.com|lvakdsrwsdggdklvwhuo
ogmdvobidsqvnidvwxck|ogmdvobidsqvnidvwxck@gmail.com|ogmdvobidsqvnidvwxck
zythiqbormcyzhvqayme|zythiqbormcyzhvqayme@gmail.com|zythiqbormcyzhvqayme
mjeoxaijkvdnvuezmatk|mjeoxaijkvdnvuezmatk@gmail.com|mjeoxaijkvdnvuezmatk
wzvbrxuotdvialwzkbas|wzvbrxuotdvialwzkbas@gmail.com|wzvbrxuotdvialwzkbas
aoqcgjwxormhttblqtzf|aoqcgjwxormhttblqtzf@gmail.com|aoqcgjwxormhttblqtzf
lzjkxkhzqjbofhixbmlh|lzjkxkhzqjbofhixbmlh@gmail.com|lzjkxkhzqjbofhixbmlh
dccqhrccghdtexpuhusw|dccqhrccghdtexpuhusw@gmail.com|dccqhrccghdtexpuhusw
gckjruhwyuukhgpuffgg|gckjruhwyuukhgpuffgg@gmail.com|gckjruhwyuukhgpuffgg
ybqqfjgbuipynupmvjuu|ybqqfjgbuipynupmvjuu@gmail.com|ybqqfjgbuipynupmvjuu
rzuejujxgbjyuxckcycs|rzuejujxgbjyuxckcycs@gmail.com|rzuejujxgbjyuxckcycs
pkktfhvjjzezqkghkffw|pkktfhvjjzezqkghkffw@gmail.com|pkktfhvjjzezqkghkffw
lzilkqwdggmvhckhoohf|lzilkqwdggmvhckhoohf@gmail.com|lzilkqwdggmvhckhoohf
wczcvzfzbsodzeagbigi|wczcvzfzbsodzeagbigi@gmail.com|wczcvzfzbsodzeagbigi
cgywiiyxjohplnijlgnc|cgywiiyxjohplnijlgnc@gmail.com|cgywiiyxjohplnijlgnc
xrvudojhomyrbsruhdvt|xrvudojhomyrbsruhdvt@gmail.com|xrvudojhomyrbsruhdvt
cuvwatqccqmxgzqeprei|cuvwatqccqmxgzqeprei@gmail.com|cuvwatqccqmxgzqeprei
tqmeswoxasvgyyvhavom|tqmeswoxasvgyyvhavom@gmail.com|tqmeswoxasvgyyvhavom
loehzeelqtrrgwhqubpp|loehzeelqtrrgwhqubpp@gmail.com|loehzeelqtrrgwhqubpp
lwnrutynoskhskikjasr|lwnrutynoskhskikjasr@gmail.com|lwnrutynoskhskikjasr
joetdxfblxvfmekpjnqs|joetdxfblxvfmekpjnqs@gmail.com|joetdxfblxvfmekpjnqs
hzrtrgxxqjklqzjekyma|hzrtrgxxqjklqzjekyma@gmail.com|hzrtrgxxqjklqzjekyma
neoduunlicbvzmgnlklk|neoduunlicbvzmgnlklk@gmail.com|neoduunlicbvzmgnlklk
azuocjhchslrxzemayrl|azuocjhchslrxzemayrl@gmail.com|azuocjhchslrxzemayrl
ginqdzrztoulydysblrt|ginqdzrztoulydysblrt@gmail.com|ginqdzrztoulydysblrt
gikhrtoinydtajyzxqis|gikhrtoinydtajyzxqis@gmail.com|gikhrtoinydtajyzxqis
rdvuphjucufokltnoozs|rdvuphjucufokltnoozs@gmail.com|rdvuphjucufokltnoozs
dahbyalbngiavpsaonrn|dahbyalbngiavpsaonrn@gmail.com|dahbyalbngiavpsaonrn
genqonkieqxiduvumqhv|genqonkieqxiduvumqhv@gmail.com|genqonkieqxiduvumqhv
dyemggzxedcnouslihxa|dyemggzxedcnouslihxa@gmail.com|dyemggzxedcnouslihxa
xdwxtpuotdpaszxjsbgi|xdwxtpuotdpaszxjsbgi@gmail.com|xdwxtpuotdpaszxjsbgi
sevbidjyypqmcksjreaz|sevbidjyypqmcksjreaz@gmail.com|sevbidjyypqmcksjreaz
glerwhvjcgmfvimidkot|glerwhvjcgmfvimidkot@gmail.com|glerwhvjcgmfvimidkot
wchxmrgrivgkqhyspier|wchxmrgrivgkqhyspier@gmail.com|wchxmrgrivgkqhyspier
fdjihfyruzwfchmudsil|fdjihfyruzwfchmudsil@gmail.com|fdjihfyruzwfchmudsil
silwtghpjlqbnwqzyxhf|silwtghpjlqbnwqzyxhf@gmail.com|silwtghpjlqbnwqzyxhf
cghxfchulfcrtdhhacdh|cghxfchulfcrtdhhacdh@gmail.com|cghxfchulfcrtdhhacdh
zuogcuhgfmgnxfndqbzb|zuogcuhgfmgnxfndqbzb@gmail.com|zuogcuhgfmgnxfndqbzb
ernfwwwjaqtizucjoczz|ernfwwwjaqtizucjoczz@gmail.com|ernfwwwjaqtizucjoczz
kdfqhrfoxpxcapcvjpcy|kdfqhrfoxpxcapcvjpcy@gmail.com|kdfqhrfoxpxcapcvjpcy
uzxyhsovnsqybrnbvfla|uzxyhsovnsqybrnbvfla@gmail.com|uzxyhsovnsqybrnbvfla
krhxbemfcljhsqcxaxqn|krhxbemfcljhsqcxaxqn@gmail.com|krhxbemfcljhsqcxaxqn
agzojyoergyvlgixnkfb|agzojyoergyvlgixnkfb@gmail.com|agzojyoergyvlgixnkfb
jrorjzdkcgevskzslokm|jrorjzdkcgevskzslokm@gmail.com|jrorjzdkcgevskzslokm
ajmxegfznspmqwhahnuq|ajmxegfznspmqwhahnuq@gmail.com|ajmxegfznspmqwhahnuq
avekoywyjvvtxgmfnmwg|avekoywyjvvtxgmfnmwg@gmail.com|avekoywyjvvtxgmfnmwg
huiggjsgnhsemwflgxbq|huiggjsgnhsemwflgxbq@gmail.com|huiggjsgnhsemwflgxbq
bqrrxyxrevrizqznaltu|bqrrxyxrevrizqznaltu@gmail.com|bqrrxyxrevrizqznaltu
veuptehrbvgrbipbnmwa|veuptehrbvgrbipbnmwa@gmail.com|veuptehrbvgrbipbnmwa
mvtgndaweifmawsoljdr|mvtgndaweifmawsoljdr@gmail.com|mvtgndaweifmawsoljdr
vommhnpzosmwcavgsklz|vommhnpzosmwcavgsklz@gmail.com|vommhnpzosmwcavgsklz
jxtunubpkjpknzeowgsq|jxtunubpkjpknzeowgsq@gmail.com|jxtunubpkjpknzeowgsq
mcolgudhqmhqsootgppp|mcolgudhqmhqsootgppp@gmail.com|mcolgudhqmhqsootgppp
sefabfovgqeioxhvknzv|sefabfovgqeioxhvknzv@gmail.com|sefabfovgqeioxhvknzv
mikoydmfvfuidwzjalbb|mikoydmfvfuidwzjalbb@gmail.com|mikoydmfvfuidwzjalbb
xfvbmuhfxfxylapdfdrt|xfvbmuhfxfxylapdfdrt@gmail.com|xfvbmuhfxfxylapdfdrt
djxogmkyslsxlrgftjlw|djxogmkyslsxlrgftjlw@gmail.com|djxogmkyslsxlrgftjlw
odzkehqknrjtrrubhujz|odzkehqknrjtrrubhujz@gmail.com|odzkehqknrjtrrubhujz
ujsjewlcwxuvruommarl|ujsjewlcwxuvruommarl@gmail.com|ujsjewlcwxuvruommarl
sdmeuoinovacajwwnvla|sdmeuoinovacajwwnvla@gmail.com|sdmeuoinovacajwwnvla
vabcopzbzebllpeqdokh|vabcopzbzebllpeqdokh@gmail.com|vabcopzbzebllpeqdokh
ohnksjamkxabxrszqtpy|ohnksjamkxabxrszqtpy@gmail.com|ohnksjamkxabxrszqtpy
oxrhlxizumcgvxfltfvo|oxrhlxizumcgvxfltfvo@gmail.com|oxrhlxizumcgvxfltfvo
jxxlvgfkhqnggfofwqbc|jxxlvgfkhqnggfofwqbc@gmail.com|jxxlvgfkhqnggfofwqbc
xlzppkjvinnowewikwrr|xlzppkjvinnowewikwrr@gmail.com|xlzppkjvinnowewikwrr
gqvtdpglvztvceeckurc|gqvtdpglvztvceeckurc@gmail.com|gqvtdpglvztvceeckurc
miballnoucbfjtacfcye|miballnoucbfjtacfcye@gmail.com|miballnoucbfjtacfcye
gvyviphbzsfqmehrbvfn|gvyviphbzsfqmehrbvfn@gmail.com|gvyviphbzsfqmehrbvfn
zzkjrhfirkrxgtvnovta|zzkjrhfirkrxgtvnovta@gmail.com|zzkjrhfirkrxgtvnovta
fzjubzqzvmjenqokzxto|fzjubzqzvmjenqokzxto@gmail.com|fzjubzqzvmjenqokzxto
pgokqjspcpussdexdepe|pgokqjspcpussdexdepe@gmail.com|pgokqjspcpussdexdepe
einrowgjbiavbrjepeig|einrowgjbiavbrjepeig@gmail.com|einrowgjbiavbrjepeig
dacyurizeomdnlrnbhiz|dacyurizeomdnlrnbhiz@gmail.com|dacyurizeomdnlrnbhiz
djrxlxoasrpqrymjjbke|djrxlxoasrpqrymjjbke@gmail.com|djrxlxoasrpqrymjjbke
usswalblvveqjqrxltke|usswalblvveqjqrxltke@gmail.com|usswalblvveqjqrxltke
cgfaxfcaskizxlteftya|cgfaxfcaskizxlteftya@gmail.com|cgfaxfcaskizxlteftya
ojegluuhkujzezuqqtim|ojegluuhkujzezuqqtim@gmail.com|ojegluuhkujzezuqqtim
jiunbuvoorrmaxygmytj|jiunbuvoorrmaxygmytj@gmail.com|jiunbuvoorrmaxygmytj
goimdbcokcfuzvsrrwil|goimdbcokcfuzvsrrwil@gmail.com|goimdbcokcfuzvsrrwil
tdrknrwrlsuwmxxtlovx|tdrknrwrlsuwmxxtlovx@gmail.com|tdrknrwrlsuwmxxtlovx
esulkbsbefpexavehckq|esulkbsbefpexavehckq@gmail.com|esulkbsbefpexavehckq
pwmwlgtzuuxvcsijmmxw|pwmwlgtzuuxvcsijmmxw@gmail.com|pwmwlgtzuuxvcsijmmxw
nmuylowijfwynarhvbtr|nmuylowijfwynarhvbtr@gmail.com|nmuylowijfwynarhvbtr
kpyyteucvcsamehbxqyd|kpyyteucvcsamehbxqyd@gmail.com|kpyyteucvcsamehbxqyd
pwxfkzeaimyeehvitrxc|pwxfkzeaimyeehvitrxc@gmail.com|pwxfkzeaimyeehvitrxc
gxyiknigxkedllgpzqgl|gxyiknigxkedllgpzqgl@gmail.com|gxyiknigxkedllgpzqgl
odiixcsntfabscznabpi|odiixcsntfabscznabpi@gmail.com|odiixcsntfabscznabpi
muqnkejoffxybtpkjgco|muqnkejoffxybtpkjgco@gmail.com|muqnkejoffxybtpkjgco
tpwavyyvakmkyoctprfj|tpwavyyvakmkyoctprfj@gmail.com|tpwavyyvakmkyoctprfj
rtidhumnwpdkkwqogtbe|rtidhumnwpdkkwqogtbe@gmail.com|rtidhumnwpdkkwqogtbe
ihvrviskmuetrkvrkfqn|ihvrviskmuetrkvrkfqn@gmail.com|ihvrviskmuetrkvrkfqn
hhkdvtqxukthscrkphnz|hhkdvtqxukthscrkphnz@gmail.com|hhkdvtqxukthscrkphnz
tiikcqhcczqejltsziay|tiikcqhcczqejltsziay@gmail.com|tiikcqhcczqejltsziay
koaiblusujwmfzivabhd|koaiblusujwmfzivabhd@gmail.com|koaiblusujwmfzivabhd
fvcmgvijdlqngftvscov|fvcmgvijdlqngftvscov@gmail.com|fvcmgvijdlqngftvscov
lemmkizbjijvuoqqhjsk|lemmkizbjijvuoqqhjsk@gmail.com|lemmkizbjijvuoqqhjsk
bnoowfpllfwvjpxauqyk|bnoowfpllfwvjpxauqyk@gmail.com|bnoowfpllfwvjpxauqyk
cwkbkfxrlilkfngnyicm|cwkbkfxrlilkfngnyicm@gmail.com|cwkbkfxrlilkfngnyicm
ivajybdbjauueaetcjvl|ivajybdbjauueaetcjvl@gmail.com|ivajybdbjauueaetcjvl
tlmysoiphzwutxemqpqg|tlmysoiphzwutxemqpqg@gmail.com|tlmysoiphzwutxemqpqg
kivmyrppwinxzdwslymz|kivmyrppwinxzdwslymz@gmail.com|kivmyrppwinxzdwslymz
qjptxuvtgvzzjwjeeske|qjptxuvtgvzzjwjeeske@gmail.com|qjptxuvtgvzzjwjeeske
syebpqkjaowvfizcqeph|syebpqkjaowvfizcqeph@gmail.com|syebpqkjaowvfizcqeph
inrbmiwnwfxprbuktwfv|inrbmiwnwfxprbuktwfv@gmail.com|inrbmiwnwfxprbuktwfv
ogtuugxwzslsvblwgdxh|ogtuugxwzslsvblwgdxh@gmail.com|ogtuugxwzslsvblwgdxh
xzdtqvwvxgnjmfgiszaj|xzdtqvwvxgnjmfgiszaj@gmail.com|xzdtqvwvxgnjmfgiszaj
piuvlbyfuxghqoqtcjzg|piuvlbyfuxghqoqtcjzg@gmail.com|piuvlbyfuxghqoqtcjzg
bnryxlvpkwvjrxwedffc|bnryxlvpkwvjrxwedffc@gmail.com|bnryxlvpkwvjrxwedffc
jbqregetnqhdbqilmsxm|jbqregetnqhdbqilmsxm@gmail.com|jbqregetnqhdbqilmsxm
ikmslmlfyscmlsrdzaot|ikmslmlfyscmlsrdzaot@gmail.com|ikmslmlfyscmlsrdzaot
yecgevzyergxrllfkdce|yecgevzyergxrllfkdce@gmail.com|yecgevzyergxrllfkdce
rztlyoifuvxmyizuyjhw|rztlyoifuvxmyizuyjhw@gmail.com|rztlyoifuvxmyizuyjhw
mjxxgibnsxnmwlnrrory|mjxxgibnsxnmwlnrrory@gmail.com|mjxxgibnsxnmwlnrrory
ludyjpglciomwnkpglra|ludyjpglciomwnkpglra@gmail.com|ludyjpglciomwnkpglra
bxfsavgjtpuwimrcgtge|bxfsavgjtpuwimrcgtge@gmail.com|bxfsavgjtpuwimrcgtge
ippvdzmkcehbtzicirqv|ippvdzmkcehbtzicirqv@gmail.com|ippvdzmkcehbtzicirqv
tkcuvrccmkqxigchjpqy|tkcuvrccmkqxigchjpqy@gmail.com|tkcuvrccmkqxigchjpqy
fsjrxzemfopmvoyttfvz|fsjrxzemfopmvoyttfvz@gmail.com|fsjrxzemfopmvoyttfvz
dteyyjsdkvnlmhgvpklp|dteyyjsdkvnlmhgvpklp@gmail.com|dteyyjsdkvnlmhgvpklp
utqezlvyktaymmpbsmov|utqezlvyktaymmpbsmov@gmail.com|utqezlvyktaymmpbsmov
jvxsgoihnyhzhshtaqyg|jvxsgoihnyhzhshtaqyg@gmail.com|jvxsgoihnyhzhshtaqyg
gxdzkhhpxabdqartmbxh|gxdzkhhpxabdqartmbxh@gmail.com|gxdzkhhpxabdqartmbxh
mnxciwcylxuccgtfgcdf|mnxciwcylxuccgtfgcdf@gmail.com|mnxciwcylxuccgtfgcdf
rywcgosuqwxfxmllorbp|rywcgosuqwxfxmllorbp@gmail.com|rywcgosuqwxfxmllorbp
lvhfmrcilrrkojhfhwnz|lvhfmrcilrrkojhfhwnz@gmail.com|lvhfmrcilrrkojhfhwnz
pdvmxrgneanfxqowwopn|pdvmxrgneanfxqowwopn@gmail.com|pdvmxrgneanfxqowwopn
jkvzsclkjdqxnkcvhiih|jkvzsclkjdqxnkcvhiih@gmail.com|jkvzsclkjdqxnkcvhiih
ebawddbdvvuehnumwauu|ebawddbdvvuehnumwauu@gmail.com|ebawddbdvvuehnumwauu
grqlfshplyittbymdneu|grqlfshplyittbymdneu@gmail.com|grqlfshplyittbymdneu
rhebataaxasmqctthzsn|rhebataaxasmqctthzsn@gmail.com|rhebataaxasmqctthzsn
wswvtudpwbjymfntypwe|wswvtudpwbjymfntypwe@gmail.com|wswvtudpwbjymfntypwe
nisecnbugnegblmbhzun|nisecnbugnegblmbhzun@gmail.com|nisecnbugnegblmbhzun
kdfmmxfoahtmmbpnqfts|kdfmmxfoahtmmbpnqfts@gmail.com|kdfmmxfoahtmmbpnqfts
svlyudbjeilacjaxwopl|svlyudbjeilacjaxwopl@gmail.com|svlyudbjeilacjaxwopl
otkbikluyojnhamkgepl|otkbikluyojnhamkgepl@gmail.com|otkbikluyojnhamkgepl
lgeczidqqgdtyueuwzja|lgeczidqqgdtyueuwzja@gmail.com|lgeczidqqgdtyueuwzja
kwmbepnxvsttckjqxtyp|kwmbepnxvsttckjqxtyp@gmail.com|kwmbepnxvsttckjqxtyp
eyuegcicrtuheajpnsir|eyuegcicrtuheajpnsir@gmail.com|eyuegcicrtuheajpnsir
ivepyssaypguuodmyekm|ivepyssaypguuodmyekm@gmail.com|ivepyssaypguuodmyekm
qsmggiklsjeppsdrvafq|qsmggiklsjeppsdrvafq@gmail.com|qsmggiklsjeppsdrvafq
civtlnkvebtvjhvwfsfp|civtlnkvebtvjhvwfsfp@gmail.com|civtlnkvebtvjhvwfsfp
bjbalrbjckdxcshtlqpq|bjbalrbjckdxcshtlqpq@gmail.com|bjbalrbjckdxcshtlqpq
fsuobtcgprmagfatixox|fsuobtcgprmagfatixox@gmail.com|fsuobtcgprmagfatixox
ngvzycpzmnkfhxkkwczp|ngvzycpzmnkfhxkkwczp@gmail.com|ngvzycpzmnkfhxkkwczp
wtprtjoergdribmxilhh|wtprtjoergdribmxilhh@gmail.com|wtprtjoergdribmxilhh
tsuwcnuotyknweoofpzf|tsuwcnuotyknweoofpzf@gmail.com|tsuwcnuotyknweoofpzf
fcqirbzofritwvsajpli|fcqirbzofritwvsajpli@gmail.com|fcqirbzofritwvsajpli
vzfvkmxrryygydwzsvsz|vzfvkmxrryygydwzsvsz@gmail.com|vzfvkmxrryygydwzsvsz
gtscycpgikgcjqxiplji|gtscycpgikgcjqxiplji@gmail.com|gtscycpgikgcjqxiplji
ugqrtwpubbmtlblwljvz|ugqrtwpubbmtlblwljvz@gmail.com|ugqrtwpubbmtlblwljvz
otydhfsmuszjuyhacbih|otydhfsmuszjuyhacbih@gmail.com|otydhfsmuszjuyhacbih
oiepsuvyvkfrdopzefqx|oiepsuvyvkfrdopzefqx@gmail.com|oiepsuvyvkfrdopzefqx
tgnyasknvsohlbbjrbdl|tgnyasknvsohlbbjrbdl@gmail.com|tgnyasknvsohlbbjrbdl
qgnikyqbwvgqflctrvvc|qgnikyqbwvgqflctrvvc@gmail.com|qgnikyqbwvgqflctrvvc
sobbnqldqarszcqpqajk|sobbnqldqarszcqpqajk@gmail.com|sobbnqldqarszcqpqajk
ckzxlmahwrjxlrkkbujx|ckzxlmahwrjxlrkkbujx@gmail.com|ckzxlmahwrjxlrkkbujx
qdceflohxwyhjazhopwj|qdceflohxwyhjazhopwj@gmail.com|qdceflohxwyhjazhopwj
ovnubvxvbkpeefiijird|ovnubvxvbkpeefiijird@gmail.com|ovnubvxvbkpeefiijird
cumqlogoedcmuxcqwtvy|cumqlogoedcmuxcqwtvy@gmail.com|cumqlogoedcmuxcqwtvy
fmylrtbdoeefcrmkhniu|fmylrtbdoeefcrmkhniu@gmail.com|fmylrtbdoeefcrmkhniu
imqdjmwjivbrxlnrizkr|imqdjmwjivbrxlnrizkr@gmail.com|imqdjmwjivbrxlnrizkr
ghbeoiyduspnuycmnenr|ghbeoiyduspnuycmnenr@gmail.com|ghbeoiyduspnuycmnenr
llbfllcbowhlmwytqrbd|llbfllcbowhlmwytqrbd@gmail.com|llbfllcbowhlmwytqrbd
hppqnchkdugzwcifnjai|hppqnchkdugzwcifnjai@gmail.com|hppqnchkdugzwcifnjai
avyixnahsdfohusjcwaw|avyixnahsdfohusjcwaw@gmail.com|avyixnahsdfohusjcwaw
oqnpzensrcqfpwujfpad|oqnpzensrcqfpwujfpad@gmail.com|oqnpzensrcqfpwujfpad
ivwvjvlfpepvmcymwjwl|ivwvjvlfpepvmcymwjwl@gmail.com|ivwvjvlfpepvmcymwjwl
ktphrpwkixtchsynayzp|ktphrpwkixtchsynayzp@gmail.com|ktphrpwkixtchsynayzp
acfsizpwxbleiefhwbzn|acfsizpwxbleiefhwbzn@gmail.com|acfsizpwxbleiefhwbzn
wprayjpducrzpyksizyh|wprayjpducrzpyksizyh@gmail.com|wprayjpducrzpyksizyh
jgrtukzyoqnuyumdevac|jgrtukzyoqnuyumdevac@gmail.com|jgrtukzyoqnuyumdevac
phewdjgqsjwrwpqnwqgl|phewdjgqsjwrwpqnwqgl@gmail.com|phewdjgqsjwrwpqnwqgl
fdryxvvugnspticwavfx|fdryxvvugnspticwavfx@gmail.com|fdryxvvugnspticwavfx
hyefbsciqxhldthpltoa|hyefbsciqxhldthpltoa@gmail.com|hyefbsciqxhldthpltoa
mfzchwwiddmrwdimijnp|mfzchwwiddmrwdimijnp@gmail.com|mfzchwwiddmrwdimijnp
abirzsnnjtpvnjropwdf|abirzsnnjtpvnjropwdf@gmail.com|abirzsnnjtpvnjropwdf
bcsjqfsvayillhfphfil|bcsjqfsvayillhfphfil@gmail.com|bcsjqfsvayillhfphfil
ponntqfrxhucbkkwlorw|ponntqfrxhucbkkwlorw@gmail.com|ponntqfrxhucbkkwlorw
tjyfjfucxljhfijbaxhl|tjyfjfucxljhfijbaxhl@gmail.com|tjyfjfucxljhfijbaxhl
svybgmmjwwyavophdkwh|svybgmmjwwyavophdkwh@gmail.com|svybgmmjwwyavophdkwh
gvewvatfxowntbcokguv|gvewvatfxowntbcokguv@gmail.com|gvewvatfxowntbcokguv
siehoqhoutyfsbpkuufx|siehoqhoutyfsbpkuufx@gmail.com|siehoqhoutyfsbpkuufx
bptnfdsljtjkpsqnbari|bptnfdsljtjkpsqnbari@gmail.com|bptnfdsljtjkpsqnbari
jnjmnwwjsgygswzhcoho|jnjmnwwjsgygswzhcoho@gmail.com|jnjmnwwjsgygswzhcoho
eajyguitgsdvimwlavyi|eajyguitgsdvimwlavyi@gmail.com|eajyguitgsdvimwlavyi
ipeybvzfqoxdntehjwvh|ipeybvzfqoxdntehjwvh@gmail.com|ipeybvzfqoxdntehjwvh
gprfsywlhfuwsiwlxwkx|gprfsywlhfuwsiwlxwkx@gmail.com|gprfsywlhfuwsiwlxwkx
lcygpitvmgtrpgckchne|lcygpitvmgtrpgckchne@gmail.com|lcygpitvmgtrpgckchne
ioqlibxzabvvyqbqbafb|ioqlibxzabvvyqbqbafb@gmail.com|ioqlibxzabvvyqbqbafb
dmttxoqpexjgfvxgfnyc|dmttxoqpexjgfvxgfnyc@gmail.com|dmttxoqpexjgfvxgfnyc
vemtlowhobydvxeqoliy|vemtlowhobydvxeqoliy@gmail.com|vemtlowhobydvxeqoliy
nbqfxjstsgszaygtbxpz|nbqfxjstsgszaygtbxpz@gmail.com|nbqfxjstsgszaygtbxpz
sefyamkjxjapkuinpyor|sefyamkjxjapkuinpyor@gmail.com|sefyamkjxjapkuinpyor
uqohrnqvdclvwemktvkx|uqohrnqvdclvwemktvkx@gmail.com|uqohrnqvdclvwemktvkx
pjhkjsfsohinpmoafupg|pjhkjsfsohinpmoafupg@gmail.com|pjhkjsfsohinpmoafupg
dktqqrrisfpqldoihgbr|dktqqrrisfpqldoihgbr@gmail.com|dktqqrrisfpqldoihgbr
ahsouthjrwvbomwqpfim|ahsouthjrwvbomwqpfim@gmail.com|ahsouthjrwvbomwqpfim
poaxfuxmskxebsdlgmuc|poaxfuxmskxebsdlgmuc@gmail.com|poaxfuxmskxebsdlgmuc
jwnedgrvbjzkkuovwnxi|jwnedgrvbjzkkuovwnxi@gmail.com|jwnedgrvbjzkkuovwnxi
qtujisghsbcnvjrcyokx|qtujisghsbcnvjrcyokx@gmail.com|qtujisghsbcnvjrcyokx
xxcbxwyheereaxwrmdil|xxcbxwyheereaxwrmdil@gmail.com|xxcbxwyheereaxwrmdil
jpelqvbrbatuoipbzlop|jpelqvbrbatuoipbzlop@gmail.com|jpelqvbrbatuoipbzlop
hrmzxnsygftyqqewsues|hrmzxnsygftyqqewsues@gmail.com|hrmzxnsygftyqqewsues
miblzmuaayaqjcprzakk|miblzmuaayaqjcprzakk@gmail.com|miblzmuaayaqjcprzakk
ayrprxplynfdonubkeig|ayrprxplynfdonubkeig@gmail.com|ayrprxplynfdonubkeig
gyiwalmeyqtpisstojhr|gyiwalmeyqtpisstojhr@gmail.com|gyiwalmeyqtpisstojhr
phklqhbxwjglpdavefze|phklqhbxwjglpdavefze@gmail.com|phklqhbxwjglpdavefze
hixoizldrummiatvuyyw|hixoizldrummiatvuyyw@gmail.com|hixoizldrummiatvuyyw
qaohatwpglrsbpctcfli|qaohatwpglrsbpctcfli@gmail.com|qaohatwpglrsbpctcfli
pcztafcpkveeuvaqdcdw|pcztafcpkveeuvaqdcdw@gmail.com|pcztafcpkveeuvaqdcdw
yqqnuyypmxchvxamixvn|yqqnuyypmxchvxamixvn@gmail.com|yqqnuyypmxchvxamixvn
rlepnzaupfgkjtltzrdi|rlepnzaupfgkjtltzrdi@gmail.com|rlepnzaupfgkjtltzrdi
gqeeydupxwhaprofbddi|gqeeydupxwhaprofbddi@gmail.com|gqeeydupxwhaprofbddi
aeklxzapvfhqwjilcqgn|aeklxzapvfhqwjilcqgn@gmail.com|aeklxzapvfhqwjilcqgn
ttmiwapfqiyxatjybhay|ttmiwapfqiyxatjybhay@gmail.com|ttmiwapfqiyxatjybhay
eixwoobwrdvqcjxkiuom|eixwoobwrdvqcjxkiuom@gmail.com|eixwoobwrdvqcjxkiuom
uqdildhttvsrgwjflhmc|uqdildhttvsrgwjflhmc@gmail.com|uqdildhttvsrgwjflhmc
fgndeihegbikqqvatnxu|fgndeihegbikqqvatnxu@gmail.com|fgndeihegbikqqvatnxu
asxqxytrgtatgshqkcgi|asxqxytrgtatgshqkcgi@gmail.com|asxqxytrgtatgshqkcgi
leaupvjrkdudhadfieso|leaupvjrkdudhadfieso@gmail.com|leaupvjrkdudhadfieso
dzkndplmhmzcjjcazohg|dzkndplmhmzcjjcazohg@gmail.com|dzkndplmhmzcjjcazohg
xlvihaotlkoecmbifixu|xlvihaotlkoecmbifixu@gmail.com|xlvihaotlkoecmbifixu
bmaxbdduxrgdmyyfyowu|bmaxbdduxrgdmyyfyowu@gmail.com|bmaxbdduxrgdmyyfyowu
vvmacalorayaotknbwka|vvmacalorayaotknbwka@gmail.com|vvmacalorayaotknbwka
jzqmyzqjjbtmnrxrgrpa|jzqmyzqjjbtmnrxrgrpa@gmail.com|jzqmyzqjjbtmnrxrgrpa
vlhvbwhkvxderwpxonep|vlhvbwhkvxderwpxonep@gmail.com|vlhvbwhkvxderwpxonep
miccynadchafllrudajm|miccynadchafllrudajm@gmail.com|miccynadchafllrudajm
ejespzqygqnxrxrugorc|ejespzqygqnxrxrugorc@gmail.com|ejespzqygqnxrxrugorc
slwabkatlivaboudkoqk|slwabkatlivaboudkoqk@gmail.com|slwabkatlivaboudkoqk
myduajuzaomjwbqelsmx|myduajuzaomjwbqelsmx@gmail.com|myduajuzaomjwbqelsmx
rnacifliwmzoyipsrdme|rnacifliwmzoyipsrdme@gmail.com|rnacifliwmzoyipsrdme
dhhfxfrdolxcdslqvbwh|dhhfxfrdolxcdslqvbwh@gmail.com|dhhfxfrdolxcdslqvbwh
qoxtynibcfllfxnrdruy|qoxtynibcfllfxnrdruy@gmail.com|qoxtynibcfllfxnrdruy
oqafathtcqkwwyekqvtm|oqafathtcqkwwyekqvtm@gmail.com|oqafathtcqkwwyekqvtm
ixexfpfummnhobzstsop|ixexfpfummnhobzstsop@gmail.com|ixexfpfummnhobzstsop
bcitsixjtwrjtvikapig|bcitsixjtwrjtvikapig@gmail.com|bcitsixjtwrjtvikapig
klzclsapmemlcbdbtmmu|klzclsapmemlcbdbtmmu@gmail.com|klzclsapmemlcbdbtmmu
nqgldrjpqhxixawpcwbz|nqgldrjpqhxixawpcwbz@gmail.com|nqgldrjpqhxixawpcwbz
badqzoamozxqjohmimwj|badqzoamozxqjohmimwj@gmail.com|badqzoamozxqjohmimwj
rldgszhbyayesjnsxujz|rldgszhbyayesjnsxujz@gmail.com|rldgszhbyayesjnsxujz
ovjyiikijchtqvhwkxay|ovjyiikijchtqvhwkxay@gmail.com|ovjyiikijchtqvhwkxay
fzodxbpqqqcaiagmlath|fzodxbpqqqcaiagmlath@gmail.com|fzodxbpqqqcaiagmlath
dfsulddzaqciankfljnc|dfsulddzaqciankfljnc@gmail.com|dfsulddzaqciankfljnc
anilballlqexidqnyhpm|anilballlqexidqnyhpm@gmail.com|anilballlqexidqnyhpm
vflzrjoystvzephoyzbe|vflzrjoystvzephoyzbe@gmail.com|vflzrjoystvzephoyzbe
cjugiucxzfklkareyfhf|cjugiucxzfklkareyfhf@gmail.com|cjugiucxzfklkareyfhf
qkbreplangqynosbgkbt|qkbreplangqynosbgkbt@gmail.com|qkbreplangqynosbgkbt
lbjhnkllfywzftxigsuv|lbjhnkllfywzftxigsuv@gmail.com|lbjhnkllfywzftxigsuv
loiqorzsadrzdnvnocke|loiqorzsadrzdnvnocke@gmail.com|loiqorzsadrzdnvnocke
kqffhzszppakaeubphur|kqffhzszppakaeubphur@gmail.com|kqffhzszppakaeubphur
rfbzoccqypozbxxlapwr|rfbzoccqypozbxxlapwr@gmail.com|rfbzoccqypozbxxlapwr
efuqcoxhegayphrpptsj|efuqcoxhegayphrpptsj@gmail.com|efuqcoxhegayphrpptsj
hhezutbyyrzsjzulikry|hhezutbyyrzsjzulikry@gmail.com|hhezutbyyrzsjzulikry
cendzlgafpajbecxfeyj|cendzlgafpajbecxfeyj@gmail.com|cendzlgafpajbecxfeyj
ibmqtxkvjiivxgbcuxgh|ibmqtxkvjiivxgbcuxgh@gmail.com|ibmqtxkvjiivxgbcuxgh
cxmqikbxgobrwlnkcvap|cxmqikbxgobrwlnkcvap@gmail.com|cxmqikbxgobrwlnkcvap
tweooasrakmuhxbkmhdn|tweooasrakmuhxbkmhdn@gmail.com|tweooasrakmuhxbkmhdn
hzevuritravjbusgxwoq|hzevuritravjbusgxwoq@gmail.com|hzevuritravjbusgxwoq
ropnnbcrbybsklxfsacv|ropnnbcrbybsklxfsacv@gmail.com|ropnnbcrbybsklxfsacv
pbbveashlnrxunafbthj|pbbveashlnrxunafbthj@gmail.com|pbbveashlnrxunafbthj
aojdtrrtoxqveseypqqq|aojdtrrtoxqveseypqqq@gmail.com|aojdtrrtoxqveseypqqq
gjoqtqwulgmiyyjfjpft|gjoqtqwulgmiyyjfjpft@gmail.com|gjoqtqwulgmiyyjfjpft
xffvfhqzcpscowwwmczv|xffvfhqzcpscowwwmczv@gmail.com|xffvfhqzcpscowwwmczv
lhmpsisieyhuqgxrlcdi|lhmpsisieyhuqgxrlcdi@gmail.com|lhmpsisieyhuqgxrlcdi
vpbxfgnucfawpziaocqv|vpbxfgnucfawpziaocqv@gmail.com|vpbxfgnucfawpziaocqv
wahicfzbzhwouepvszwn|wahicfzbzhwouepvszwn@gmail.com|wahicfzbzhwouepvszwn
chllslrsxtrmgumdgxoi|chllslrsxtrmgumdgxoi@gmail.com|chllslrsxtrmgumdgxoi
mrljdqdfaunothflamum|mrljdqdfaunothflamum@gmail.com|mrljdqdfaunothflamum
xdefkoytqqkhbnqtcerq|xdefkoytqqkhbnqtcerq@gmail.com|xdefkoytqqkhbnqtcerq
bpjoutwculquzvjqbrsv|bpjoutwculquzvjqbrsv@gmail.com|bpjoutwculquzvjqbrsv
kildxretscgxhrdxuylj|kildxretscgxhrdxuylj@gmail.com|kildxretscgxhrdxuylj
vewntycstmtsiuamjldp|vewntycstmtsiuamjldp@gmail.com|vewntycstmtsiuamjldp
bcopckhzhzrwzeiwcoad|bcopckhzhzrwzeiwcoad@gmail.com|bcopckhzhzrwzeiwcoad
hupmweiupxsrijmivkts|hupmweiupxsrijmivkts@gmail.com|hupmweiupxsrijmivkts
zelaqcanqndlhzxgrnjf|zelaqcanqndlhzxgrnjf@gmail.com|zelaqcanqndlhzxgrnjf
jfpsgooibhfzzznolisi|jfpsgooibhfzzznolisi@gmail.com|jfpsgooibhfzzznolisi
omkmdbrnyqcrqepfgdcx|omkmdbrnyqcrqepfgdcx@gmail.com|omkmdbrnyqcrqepfgdcx
admfvrtzdzzamllrrlfk|admfvrtzdzzamllrrlfk@gmail.com|admfvrtzdzzamllrrlfk
wlyrqkqpnzoogqpfctvd|wlyrqkqpnzoogqpfctvd@gmail.com|wlyrqkqpnzoogqpfctvd
dyfgxulhwxplnovyofrv|dyfgxulhwxplnovyofrv@gmail.com|dyfgxulhwxplnovyofrv
uhtdyjfexltdezpftiuq|uhtdyjfexltdezpftiuq@gmail.com|uhtdyjfexltdezpftiuq
awiewglaoqtfbyagxgby|awiewglaoqtfbyagxgby@gmail.com|awiewglaoqtfbyagxgby
koegjcvzhzwfhjavsevr|koegjcvzhzwfhjavsevr@gmail.com|koegjcvzhzwfhjavsevr
ggaideeqsftctudgttyk|ggaideeqsftctudgttyk@gmail.com|ggaideeqsftctudgttyk
rfppleozetikwjtcnalo|rfppleozetikwjtcnalo@gmail.com|rfppleozetikwjtcnalo
ibxjwpavqzswbevfzqgb|ibxjwpavqzswbevfzqgb@gmail.com|ibxjwpavqzswbevfzqgb
piwhpgaihlfmuucppxkm|piwhpgaihlfmuucppxkm@gmail.com|piwhpgaihlfmuucppxkm
lsldsqyfaqfhkdopqdnc|lsldsqyfaqfhkdopqdnc@gmail.com|lsldsqyfaqfhkdopqdnc
vluobnhaiplszjktyaai|vluobnhaiplszjktyaai@gmail.com|vluobnhaiplszjktyaai
evhysgusyuubygxqxyzf|evhysgusyuubygxqxyzf@gmail.com|evhysgusyuubygxqxyzf
xupvkrykdfiiqdyhrbmf|xupvkrykdfiiqdyhrbmf@gmail.com|xupvkrykdfiiqdyhrbmf
eeprhdqdymyxvufkbqnw|eeprhdqdymyxvufkbqnw@gmail.com|eeprhdqdymyxvufkbqnw
nueglabjmatxcwzveskv|nueglabjmatxcwzveskv@gmail.com|nueglabjmatxcwzveskv
qgapbihoruuosapaqpuu|qgapbihoruuosapaqpuu@gmail.com|qgapbihoruuosapaqpuu
drjflmnnpdikxuywymyr|drjflmnnpdikxuywymyr@gmail.com|drjflmnnpdikxuywymyr
rijvmimahhwbkabfjuwg|rijvmimahhwbkabfjuwg@gmail.com|rijvmimahhwbkabfjuwg
musmdhvnwksrwiszwpys|musmdhvnwksrwiszwpys@gmail.com|musmdhvnwksrwiszwpys
lkrowptmcveamenagmza|lkrowptmcveamenagmza@gmail.com|lkrowptmcveamenagmza
fauvisnheadghixmcumg|fauvisnheadghixmcumg@gmail.com|fauvisnheadghixmcumg
deirxuegyfuxqgsvoaat|deirxuegyfuxqgsvoaat@gmail.com|deirxuegyfuxqgsvoaat
rbhbayvhukxudqorsjiz|rbhbayvhukxudqorsjiz@gmail.com|rbhbayvhukxudqorsjiz
jznfsmmfkbjuajbghqmk|jznfsmmfkbjuajbghqmk@gmail.com|jznfsmmfkbjuajbghqmk
ytwicrsqshwkdfjfaklj|ytwicrsqshwkdfjfaklj@gmail.com|ytwicrsqshwkdfjfaklj
jervkhgfnwizutgyxfgh|jervkhgfnwizutgyxfgh@gmail.com|jervkhgfnwizutgyxfgh
hcmslgmczmafklaxkcsf|hcmslgmczmafklaxkcsf@gmail.com|hcmslgmczmafklaxkcsf
ijrdrmbnczglutrlwepy|ijrdrmbnczglutrlwepy@gmail.com|ijrdrmbnczglutrlwepy
opnjbzvyosoxgpndxbya|opnjbzvyosoxgpndxbya@gmail.com|opnjbzvyosoxgpndxbya
rlofrpjvmdjkogsavqon|rlofrpjvmdjkogsavqon@gmail.com|rlofrpjvmdjkogsavqon
gjjqmbihckaayovjxdye|gjjqmbihckaayovjxdye@gmail.com|gjjqmbihckaayovjxdye
xgytltuxeatwmlbedhxf|xgytltuxeatwmlbedhxf@gmail.com|xgytltuxeatwmlbedhxf
oesygmggvcrwcvbbvwep|oesygmggvcrwcvbbvwep@gmail.com|oesygmggvcrwcvbbvwep
fcnpvgstvmdorhwvrosj|fcnpvgstvmdorhwvrosj@gmail.com|fcnpvgstvmdorhwvrosj
wnpnxiuuurojuskvykmu|wnpnxiuuurojuskvykmu@gmail.com|wnpnxiuuurojuskvykmu
emwuszfcambwzpwepked|emwuszfcambwzpwepked@gmail.com|emwuszfcambwzpwepked
qdgkfkkgnhznjazwbcit|qdgkfkkgnhznjazwbcit@gmail.com|qdgkfkkgnhznjazwbcit
appaxjokvxwjtylzzwov|appaxjokvxwjtylzzwov@gmail.com|appaxjokvxwjtylzzwov
fjxfmkbeslbpnbrpiwvl|fjxfmkbeslbpnbrpiwvl@gmail.com|fjxfmkbeslbpnbrpiwvl
wmuukdkmyfnbqowwnojf|wmuukdkmyfnbqowwnojf@gmail.com|wmuukdkmyfnbqowwnojf
bgqtnvufadepjpalhyra|bgqtnvufadepjpalhyra@gmail.com|bgqtnvufadepjpalhyra
kppporbnecpdvewrcvfj|kppporbnecpdvewrcvfj@gmail.com|kppporbnecpdvewrcvfj
vusfnelbatdewghiriui|vusfnelbatdewghiriui@gmail.com|vusfnelbatdewghiriui
zrfylmamolkpcudqkrlo|zrfylmamolkpcudqkrlo@gmail.com|zrfylmamolkpcudqkrlo
bpmppqfqaovvovndsarf|bpmppqfqaovvovndsarf@gmail.com|bpmppqfqaovvovndsarf
foflpuhwclkhmjhggxmu|foflpuhwclkhmjhggxmu@gmail.com|foflpuhwclkhmjhggxmu
ufomxxeliqnnbyggkrue|ufomxxeliqnnbyggkrue@gmail.com|ufomxxeliqnnbyggkrue
gqjiybgjmgwbvbdvxmsm|gqjiybgjmgwbvbdvxmsm@gmail.com|gqjiybgjmgwbvbdvxmsm
ezjlxzqfbhcdpqczmlrf|ezjlxzqfbhcdpqczmlrf@gmail.com|ezjlxzqfbhcdpqczmlrf
etdlyewtnyiskophalwl|etdlyewtnyiskophalwl@gmail.com|etdlyewtnyiskophalwl
dqjntczvbfhnhhpgfvip|dqjntczvbfhnhhpgfvip@gmail.com|dqjntczvbfhnhhpgfvip
pgkcickjsvknegfhsrdh|pgkcickjsvknegfhsrdh@gmail.com|pgkcickjsvknegfhsrdh
ausqafmjmpfocsjwkgsn|ausqafmjmpfocsjwkgsn@gmail.com|ausqafmjmpfocsjwkgsn
pftxxaghbszadncayzri|pftxxaghbszadncayzri@gmail.com|pftxxaghbszadncayzri
xwbvzofbvfxetcjimhhe|xwbvzofbvfxetcjimhhe@gmail.com|xwbvzofbvfxetcjimhhe
ucnuaizvtgvmykmywbnc|ucnuaizvtgvmykmywbnc@gmail.com|ucnuaizvtgvmykmywbnc
vcjlzzwaxwuptyxhrmia|vcjlzzwaxwuptyxhrmia@gmail.com|vcjlzzwaxwuptyxhrmia
qzxewsasvuhqnwvzdlrd|qzxewsasvuhqnwvzdlrd@gmail.com|qzxewsasvuhqnwvzdlrd
zwtscxiqdmonoepelftx|zwtscxiqdmonoepelftx@gmail.com|zwtscxiqdmonoepelftx
hbstyokeabqizqphkssz|hbstyokeabqizqphkssz@gmail.com|hbstyokeabqizqphkssz
uhjatmmhabzxmtvfpymt|uhjatmmhabzxmtvfpymt@gmail.com|uhjatmmhabzxmtvfpymt
gtzyofwdwmijgdpjenem|gtzyofwdwmijgdpjenem@gmail.com|gtzyofwdwmijgdpjenem
bbxfxwopfqlysumbxnnv|bbxfxwopfqlysumbxnnv@gmail.com|bbxfxwopfqlysumbxnnv
hqyshyxdecyjnawebgni|hqyshyxdecyjnawebgni@gmail.com|hqyshyxdecyjnawebgni
byqpchxmvucqxjmmswpl|byqpchxmvucqxjmmswpl@gmail.com|byqpchxmvucqxjmmswpl
acniktstauhslbbqdfpu|acniktstauhslbbqdfpu@gmail.com|acniktstauhslbbqdfpu
sjbzrasogqhqgfkutqye|sjbzrasogqhqgfkutqye@gmail.com|sjbzrasogqhqgfkutqye
tzohzwuulaknzrvrytqm|tzohzwuulaknzrvrytqm@gmail.com|tzohzwuulaknzrvrytqm
kqgrgjdltqahynbzlxia|kqgrgjdltqahynbzlxia@gmail.com|kqgrgjdltqahynbzlxia
xfwucdxzymdxfsklvdxy|xfwucdxzymdxfsklvdxy@gmail.com|xfwucdxzymdxfsklvdxy
cnudqtqmtegodlrvtfvm|cnudqtqmtegodlrvtfvm@gmail.com|cnudqtqmtegodlrvtfvm
mcwnwwhnapvsdetpvold|mcwnwwhnapvsdetpvold@gmail.com|mcwnwwhnapvsdetpvold
mfzqlzuwioupuvldhncs|mfzqlzuwioupuvldhncs@gmail.com|mfzqlzuwioupuvldhncs
wtcsvxmeuzkyqydmdpcn|wtcsvxmeuzkyqydmdpcn@gmail.com|wtcsvxmeuzkyqydmdpcn
ixqskejbdgkjuzuvwiyz|ixqskejbdgkjuzuvwiyz@gmail.com|ixqskejbdgkjuzuvwiyz
dssvwdvrbdakmolnaifi|dssvwdvrbdakmolnaifi@gmail.com|dssvwdvrbdakmolnaifi
ysvvhdfwpcduhmnmqtxd|ysvvhdfwpcduhmnmqtxd@gmail.com|ysvvhdfwpcduhmnmqtxd
lorsihnvmckgoxytgrau|lorsihnvmckgoxytgrau@gmail.com|lorsihnvmckgoxytgrau
lalzflphzagmnqoocnvl|lalzflphzagmnqoocnvl@gmail.com|lalzflphzagmnqoocnvl
eovkmqolzbhrmfknwztg|eovkmqolzbhrmfknwztg@gmail.com|eovkmqolzbhrmfknwztg
gymqczhmmzcxmletijht|gymqczhmmzcxmletijht@gmail.com|gymqczhmmzcxmletijht
jyvemxjmkmztbofadsxz|jyvemxjmkmztbofadsxz@gmail.com|jyvemxjmkmztbofadsxz
uhugoefvgesngpmomobk|uhugoefvgesngpmomobk@gmail.com|uhugoefvgesngpmomobk
efldigrkyefhwiwhfecp|efldigrkyefhwiwhfecp@gmail.com|efldigrkyefhwiwhfecp
jiinyhkwapakowvbqsem|jiinyhkwapakowvbqsem@gmail.com|jiinyhkwapakowvbqsem
xodfofddxsntlzgopewg|xodfofddxsntlzgopewg@gmail.com|xodfofddxsntlzgopewg
plbxddqjejjnafqkyzug|plbxddqjejjnafqkyzug@gmail.com|plbxddqjejjnafqkyzug
elrniugsfykkqoezsqrc|elrniugsfykkqoezsqrc@gmail.com|elrniugsfykkqoezsqrc
zmeavszfcasezkbjvjsk|zmeavszfcasezkbjvjsk@gmail.com|zmeavszfcasezkbjvjsk
gutctzwbyjlazrhydori|gutctzwbyjlazrhydori@gmail.com|gutctzwbyjlazrhydori
mnjmximzszljdvrsoumn|mnjmximzszljdvrsoumn@gmail.com|mnjmximzszljdvrsoumn
syivtqgylukwqsywegtk|syivtqgylukwqsywegtk@gmail.com|syivtqgylukwqsywegtk
hmtakqrseihqklzujdfs|hmtakqrseihqklzujdfs@gmail.com|hmtakqrseihqklzujdfs
crfhnlnnbtqupsuaiegf|crfhnlnnbtqupsuaiegf@gmail.com|crfhnlnnbtqupsuaiegf
cundkwlykzqjpfuqrfol|cundkwlykzqjpfuqrfol@gmail.com|cundkwlykzqjpfuqrfol
vrqkinpfmzfqksemhdmh|vrqkinpfmzfqksemhdmh@gmail.com|vrqkinpfmzfqksemhdmh
awygchqmxfuvgllanzkd|awygchqmxfuvgllanzkd@gmail.com|awygchqmxfuvgllanzkd
ergcmayosdcrxnvudbkv|ergcmayosdcrxnvudbkv@gmail.com|ergcmayosdcrxnvudbkv
cpnvmviwqtcazsbqkvfb|cpnvmviwqtcazsbqkvfb@gmail.com|cpnvmviwqtcazsbqkvfb
ddrzuaqtdhsvzpskpohy|ddrzuaqtdhsvzpskpohy@gmail.com|ddrzuaqtdhsvzpskpohy
rmjjsgxzbxuxpoqonmjw|rmjjsgxzbxuxpoqonmjw@gmail.com|rmjjsgxzbxuxpoqonmjw
bpszeqqocmtgdsjvosdh|bpszeqqocmtgdsjvosdh@gmail.com|bpszeqqocmtgdsjvosdh
upvdurwvljboxbwrbudv|upvdurwvljboxbwrbudv@gmail.com|upvdurwvljboxbwrbudv
nvswvfngnrnasukywbzq|nvswvfngnrnasukywbzq@gmail.com|nvswvfngnrnasukywbzq
mnebeaxjxkdqnhidsojr|mnebeaxjxkdqnhidsojr@gmail.com|mnebeaxjxkdqnhidsojr
tlzpdgkbxsjzynmdgyoa|tlzpdgkbxsjzynmdgyoa@gmail.com|tlzpdgkbxsjzynmdgyoa
lqpmkcqlcgcqcnnybxhu|lqpmkcqlcgcqcnnybxhu@gmail.com|lqpmkcqlcgcqcnnybxhu
wnltxbyxtzegytxfdpfa|wnltxbyxtzegytxfdpfa@gmail.com|wnltxbyxtzegytxfdpfa
lyhjiyirybqwxlfpevqe|lyhjiyirybqwxlfpevqe@gmail.com|lyhjiyirybqwxlfpevqe
moyvsoyqrerwvccyjwkx|moyvsoyqrerwvccyjwkx@gmail.com|moyvsoyqrerwvccyjwkx
gehwamspvsdfwkadyurq|gehwamspvsdfwkadyurq@gmail.com|gehwamspvsdfwkadyurq
spemjqycdyxsxcibfaem|spemjqycdyxsxcibfaem@gmail.com|spemjqycdyxsxcibfaem
bimhmoynxddlhwmhmvgv|bimhmoynxddlhwmhmvgv@gmail.com|bimhmoynxddlhwmhmvgv
sfafxkhojvkdydgiajog|sfafxkhojvkdydgiajog@gmail.com|sfafxkhojvkdydgiajog
utdgwhtsrwewrwmeswnc|utdgwhtsrwewrwmeswnc@gmail.com|utdgwhtsrwewrwmeswnc
bcmzlvalhhaahbonavhw|bcmzlvalhhaahbonavhw@gmail.com|bcmzlvalhhaahbonavhw
coimncfcckmdpektkthe|coimncfcckmdpektkthe@gmail.com|coimncfcckmdpektkthe
xjimmiakwdsaeeymltmc|xjimmiakwdsaeeymltmc@gmail.com|xjimmiakwdsaeeymltmc
fdkvlwadxmscswmyaqjx|fdkvlwadxmscswmyaqjx@gmail.com|fdkvlwadxmscswmyaqjx
zjyqbmgfomzhlnlrbejf|zjyqbmgfomzhlnlrbejf@gmail.com|zjyqbmgfomzhlnlrbejf
vyklvfmbvawhxskbysnv|vyklvfmbvawhxskbysnv@gmail.com|vyklvfmbvawhxskbysnv
ttezqxrihghjlvhucpko|ttezqxrihghjlvhucpko@gmail.com|ttezqxrihghjlvhucpko
gylbqrsojvndgbwngsih|gylbqrsojvndgbwngsih@gmail.com|gylbqrsojvndgbwngsih
khsuowowseqdfoyyrhaj|khsuowowseqdfoyyrhaj@gmail.com|khsuowowseqdfoyyrhaj
qtxlntvjglbsfabybajs|qtxlntvjglbsfabybajs@gmail.com|qtxlntvjglbsfabybajs
bxzduoslyqbmpjrupplu|bxzduoslyqbmpjrupplu@gmail.com|bxzduoslyqbmpjrupplu
gusrrdmawqgklmsmrgbe|gusrrdmawqgklmsmrgbe@gmail.com|gusrrdmawqgklmsmrgbe
tmtvbtlbusoypoodpwhb|tmtvbtlbusoypoodpwhb@gmail.com|tmtvbtlbusoypoodpwhb
tiedgvtrocwlxwszipsx|tiedgvtrocwlxwszipsx@gmail.com|tiedgvtrocwlxwszipsx
recfwaoyllefymqgrdre|recfwaoyllefymqgrdre@gmail.com|recfwaoyllefymqgrdre
ptlnlgjpeiyhafjbnsaj|ptlnlgjpeiyhafjbnsaj@gmail.com|ptlnlgjpeiyhafjbnsaj
glnwqfqjpbbnaclmxhjv|glnwqfqjpbbnaclmxhjv@gmail.com|glnwqfqjpbbnaclmxhjv
hsibgbqqghtuhqapxovv|hsibgbqqghtuhqapxovv@gmail.com|hsibgbqqghtuhqapxovv
ypdlgutwptrilcwjpahe|ypdlgutwptrilcwjpahe@gmail.com|ypdlgutwptrilcwjpahe
tqxssappdoojfmgbzkoj|tqxssappdoojfmgbzkoj@gmail.com|tqxssappdoojfmgbzkoj
ixmtmxbnrmkmqaiusmkl|ixmtmxbnrmkmqaiusmkl@gmail.com|ixmtmxbnrmkmqaiusmkl
nrqhxuvrrrrhmzezsqlo|nrqhxuvrrrrhmzezsqlo@gmail.com|nrqhxuvrrrrhmzezsqlo
npwzorryqkurqnjaoqju|npwzorryqkurqnjaoqju@gmail.com|npwzorryqkurqnjaoqju
qztmpbavhnkormhtcddc|qztmpbavhnkormhtcddc@gmail.com|qztmpbavhnkormhtcddc
ofaaczbkaovedyhvzzjo|ofaaczbkaovedyhvzzjo@gmail.com|ofaaczbkaovedyhvzzjo
gmohxjysitockgbgvkns|gmohxjysitockgbgvkns@gmail.com|gmohxjysitockgbgvkns
lcxrhpqqgrcvodhlccxb|lcxrhpqqgrcvodhlccxb@gmail.com|lcxrhpqqgrcvodhlccxb
qesrwpygyghaxdqszcyy|qesrwpygyghaxdqszcyy@gmail.com|qesrwpygyghaxdqszcyy
wneijjymkdxheaouinsy|wneijjymkdxheaouinsy@gmail.com|wneijjymkdxheaouinsy
icgtgfphhzpsyccwadbl|icgtgfphhzpsyccwadbl@gmail.com|icgtgfphhzpsyccwadbl
ypfzatslktthuwgrrmwa|ypfzatslktthuwgrrmwa@gmail.com|ypfzatslktthuwgrrmwa
tflvtaodaglpzttyangl|tflvtaodaglpzttyangl@gmail.com|tflvtaodaglpzttyangl
jwqinykaallnarsxapfk|jwqinykaallnarsxapfk@gmail.com|jwqinykaallnarsxapfk
hemjtlexseuqourpjjuw|hemjtlexseuqourpjjuw@gmail.com|hemjtlexseuqourpjjuw
woxrejmgmrlolcsehjtq|woxrejmgmrlolcsehjtq@gmail.com|woxrejmgmrlolcsehjtq
qupocdkbeqiaolqrcasg|qupocdkbeqiaolqrcasg@gmail.com|qupocdkbeqiaolqrcasg
qwbjsawqwalzxiymojcx|qwbjsawqwalzxiymojcx@gmail.com|qwbjsawqwalzxiymojcx
epqnwwfgqoqyhjqcclqs|epqnwwfgqoqyhjqcclqs@gmail.com|epqnwwfgqoqyhjqcclqs
calpnrnbnjtfrospiywt|calpnrnbnjtfrospiywt@gmail.com|calpnrnbnjtfrospiywt
zcgheooxtljhvmzngnvk|zcgheooxtljhvmzngnvk@gmail.com|zcgheooxtljhvmzngnvk
scaaepzkciqxioovflot|scaaepzkciqxioovflot@gmail.com|scaaepzkciqxioovflot
afdisqyrasdnzbrrqqug|afdisqyrasdnzbrrqqug@gmail.com|afdisqyrasdnzbrrqqug
rvayzzaebutqunvudzdp|rvayzzaebutqunvudzdp@gmail.com|rvayzzaebutqunvudzdp
fhxcdkwkkgktutsveuxv|fhxcdkwkkgktutsveuxv@gmail.com|fhxcdkwkkgktutsveuxv
vpcienmecqweojsbszsa|vpcienmecqweojsbszsa@gmail.com|vpcienmecqweojsbszsa
ejekgfoucmtwsorqqoel|ejekgfoucmtwsorqqoel@gmail.com|ejekgfoucmtwsorqqoel
zhotqhearikdxjkpllrr|zhotqhearikdxjkpllrr@gmail.com|zhotqhearikdxjkpllrr
ewewihmcrosveiwebcyc|ewewihmcrosveiwebcyc@gmail.com|ewewihmcrosveiwebcyc
upnqtygqvhpxjwxrnxpg|upnqtygqvhpxjwxrnxpg@gmail.com|upnqtygqvhpxjwxrnxpg
qaiewxerlwrbzzocoqmt|qaiewxerlwrbzzocoqmt@gmail.com|qaiewxerlwrbzzocoqmt
htpbtqjwpvtgawyalbhf|htpbtqjwpvtgawyalbhf@gmail.com|htpbtqjwpvtgawyalbhf
wshnmgjxtbckjlhewafk|wshnmgjxtbckjlhewafk@gmail.com|wshnmgjxtbckjlhewafk
fguvwqvgdunkflwpzwrm|fguvwqvgdunkflwpzwrm@gmail.com|fguvwqvgdunkflwpzwrm
isfzjirlqdkdknoxdkve|isfzjirlqdkdknoxdkve@gmail.com|isfzjirlqdkdknoxdkve
snnqtycbsmcebiycwbml|snnqtycbsmcebiycwbml@gmail.com|snnqtycbsmcebiycwbml
ntgydrtrvbojhnbtuynu|ntgydrtrvbojhnbtuynu@gmail.com|ntgydrtrvbojhnbtuynu
noytgegiqspdgcpmsyno|noytgegiqspdgcpmsyno@gmail.com|noytgegiqspdgcpmsyno
hddmkmoculfiomqyxmzl|hddmkmoculfiomqyxmzl@gmail.com|hddmkmoculfiomqyxmzl
lqsjcwitsgwcyytfuxxs|lqsjcwitsgwcyytfuxxs@gmail.com|lqsjcwitsgwcyytfuxxs
rfnsikwdtzguwyqeebaw|rfnsikwdtzguwyqeebaw@gmail.com|rfnsikwdtzguwyqeebaw
qrgfogxbykmdumxjgysc|qrgfogxbykmdumxjgysc@gmail.com|qrgfogxbykmdumxjgysc
prkhzyasanjktmudsrtq|prkhzyasanjktmudsrtq@gmail.com|prkhzyasanjktmudsrtq
vynxnbxozdnqfhhkiepk|vynxnbxozdnqfhhkiepk@gmail.com|vynxnbxozdnqfhhkiepk
ylvrpifghnpmpifkjfkk|ylvrpifghnpmpifkjfkk@gmail.com|ylvrpifghnpmpifkjfkk
urutyccfbintauxzpvum|urutyccfbintauxzpvum@gmail.com|urutyccfbintauxzpvum
enbgkbiyqeuxfvrsqzde|enbgkbiyqeuxfvrsqzde@gmail.com|enbgkbiyqeuxfvrsqzde
xzhrvzqvbftwjyewrczh|xzhrvzqvbftwjyewrczh@gmail.com|xzhrvzqvbftwjyewrczh
wcllcoutxejvcswzohem|wcllcoutxejvcswzohem@gmail.com|wcllcoutxejvcswzohem
txlioyuztdhazktuswcn|txlioyuztdhazktuswcn@gmail.com|txlioyuztdhazktuswcn
nahrfvrvvtkuqqcqqmti|nahrfvrvvtkuqqcqqmti@gmail.com|nahrfvrvvtkuqqcqqmti
eukbwchcwuoakhaiepoq|eukbwchcwuoakhaiepoq@gmail.com|eukbwchcwuoakhaiepoq
umvjfucsccztymcwcswe|umvjfucsccztymcwcswe@gmail.com|umvjfucsccztymcwcswe
yqlxwyktnqhoikiigddf|yqlxwyktnqhoikiigddf@gmail.com|yqlxwyktnqhoikiigddf
kxmhkiegfoixzfdxcjqi|kxmhkiegfoixzfdxcjqi@gmail.com|kxmhkiegfoixzfdxcjqi
eyktgtyeyzlplumguxtf|eyktgtyeyzlplumguxtf@gmail.com|eyktgtyeyzlplumguxtf
lhctztvseobifmyxchuh|lhctztvseobifmyxchuh@gmail.com|lhctztvseobifmyxchuh
ottuupbjoasnolqrxhjt|ottuupbjoasnolqrxhjt@gmail.com|ottuupbjoasnolqrxhjt
xhuzsfioxrgooxmrbrwt|xhuzsfioxrgooxmrbrwt@gmail.com|xhuzsfioxrgooxmrbrwt
tngjpdquvgiatvuevkkq|tngjpdquvgiatvuevkkq@gmail.com|tngjpdquvgiatvuevkkq
ukuzygywcdihfesaqtab|ukuzygywcdihfesaqtab@gmail.com|ukuzygywcdihfesaqtab
kxguiismqgcndlnyrako|kxguiismqgcndlnyrako@gmail.com|kxguiismqgcndlnyrako
kuuskhhxxtaasromhfnq|kuuskhhxxtaasromhfnq@gmail.com|kuuskhhxxtaasromhfnq
agwuigfunhrfjxaqgjdh|agwuigfunhrfjxaqgjdh@gmail.com|agwuigfunhrfjxaqgjdh
shesdhrahuqhvyplaqxy|shesdhrahuqhvyplaqxy@gmail.com|shesdhrahuqhvyplaqxy
agpfiljoeentadbwgztl|agpfiljoeentadbwgztl@gmail.com|agpfiljoeentadbwgztl
opqoeiylycoslvwnwjts|opqoeiylycoslvwnwjts@gmail.com|opqoeiylycoslvwnwjts
oodhotismdbinbtymeks|oodhotismdbinbtymeks@gmail.com|oodhotismdbinbtymeks
otvbxqwvuqkdchlrlhym|otvbxqwvuqkdchlrlhym@gmail.com|otvbxqwvuqkdchlrlhym
ydqljlglbfulogyxmzus|ydqljlglbfulogyxmzus@gmail.com|ydqljlglbfulogyxmzus
usltwzmlwsiobnxapsbd|usltwzmlwsiobnxapsbd@gmail.com|usltwzmlwsiobnxapsbd
ozifzuqtunvhesnwjgmu|ozifzuqtunvhesnwjgmu@gmail.com|ozifzuqtunvhesnwjgmu
djfhhjbqlzstygnrlyrt|djfhhjbqlzstygnrlyrt@gmail.com|djfhhjbqlzstygnrlyrt
atxkiowbgzmwzgevafcl|atxkiowbgzmwzgevafcl@gmail.com|atxkiowbgzmwzgevafcl
helnawzorkiwzpwbieca|helnawzorkiwzpwbieca@gmail.com|helnawzorkiwzpwbieca
sozfhuvzkqukqwcsahje|sozfhuvzkqukqwcsahje@gmail.com|sozfhuvzkqukqwcsahje
hpfgywjdgdihclmedhfl|hpfgywjdgdihclmedhfl@gmail.com|hpfgywjdgdihclmedhfl
cmaerqcuiewwlxppolee|cmaerqcuiewwlxppolee@gmail.com|cmaerqcuiewwlxppolee
icnbhgnoseuqryrkfkhs|icnbhgnoseuqryrkfkhs@gmail.com|icnbhgnoseuqryrkfkhs
sxcbcjiosgbqutldsyew|sxcbcjiosgbqutldsyew@gmail.com|sxcbcjiosgbqutldsyew
xshbanfsptdxfjzuiuyj|xshbanfsptdxfjzuiuyj@gmail.com|xshbanfsptdxfjzuiuyj
aczbjruagqnapirhcjrp|aczbjruagqnapirhcjrp@gmail.com|aczbjruagqnapirhcjrp
uvaeernzsezqvxcjvxsz|uvaeernzsezqvxcjvxsz@gmail.com|uvaeernzsezqvxcjvxsz
gaipnrqxhwqblielbqos|gaipnrqxhwqblielbqos@gmail.com|gaipnrqxhwqblielbqos
edlmtkhpilfvtkkpmbbo|edlmtkhpilfvtkkpmbbo@gmail.com|edlmtkhpilfvtkkpmbbo
sftwlzgqbsdgkqthyogr|sftwlzgqbsdgkqthyogr@gmail.com|sftwlzgqbsdgkqthyogr
bufjflintqljrjivnmnn|bufjflintqljrjivnmnn@gmail.com|bufjflintqljrjivnmnn
wxpsoflobtsddgwkxira|wxpsoflobtsddgwkxira@gmail.com|wxpsoflobtsddgwkxira
mdbuwanwdxgadxzpkdfe|mdbuwanwdxgadxzpkdfe@gmail.com|mdbuwanwdxgadxzpkdfe
nwtgnqggppixaldnkijl|nwtgnqggppixaldnkijl@gmail.com|nwtgnqggppixaldnkijl
emeovzwblzvqpcevyggh|emeovzwblzvqpcevyggh@gmail.com|emeovzwblzvqpcevyggh
ewawerxtiisngqufdvco|ewawerxtiisngqufdvco@gmail.com|ewawerxtiisngqufdvco
tuqorwbefneuocijroxl|tuqorwbefneuocijroxl@gmail.com|tuqorwbefneuocijroxl
ugyrjcyyrxkosgsvpxdw|ugyrjcyyrxkosgsvpxdw@gmail.com|ugyrjcyyrxkosgsvpxdw
pbxowmoyqjruhzdtcfpa|pbxowmoyqjruhzdtcfpa@gmail.com|pbxowmoyqjruhzdtcfpa
pqsmuewulbqexxbakgan|pqsmuewulbqexxbakgan@gmail.com|pqsmuewulbqexxbakgan
aqxywglpyzqergwteunw|aqxywglpyzqergwteunw@gmail.com|aqxywglpyzqergwteunw
vygjyxgnoykgbsqrqiwz|vygjyxgnoykgbsqrqiwz@gmail.com|vygjyxgnoykgbsqrqiwz
kcjgnigzzunhkvoxdmwu|kcjgnigzzunhkvoxdmwu@gmail.com|kcjgnigzzunhkvoxdmwu
osqnrhmuozsxizthjsih|osqnrhmuozsxizthjsih@gmail.com|osqnrhmuozsxizthjsih
zvbulyjtfxxafwikglaa|zvbulyjtfxxafwikglaa@gmail.com|zvbulyjtfxxafwikglaa
rfvhecwqeahdqfxdmpng|rfvhecwqeahdqfxdmpng@gmail.com|rfvhecwqeahdqfxdmpng
ctzrejegonkqalwmopvr|ctzrejegonkqalwmopvr@gmail.com|ctzrejegonkqalwmopvr
jfikkdvfrxkavxujtoog|jfikkdvfrxkavxujtoog@gmail.com|jfikkdvfrxkavxujtoog
jkcbtlnprwleupgsgckq|jkcbtlnprwleupgsgckq@gmail.com|jkcbtlnprwleupgsgckq
tzvywbnncdskeqohtojm|tzvywbnncdskeqohtojm@gmail.com|tzvywbnncdskeqohtojm
iwgddpsnpkcqiziuskzs|iwgddpsnpkcqiziuskzs@gmail.com|iwgddpsnpkcqiziuskzs
gmrnpmykfnavmkbocaaz|gmrnpmykfnavmkbocaaz@gmail.com|gmrnpmykfnavmkbocaaz
jrafmwvldnpyuceppadd|jrafmwvldnpyuceppadd@gmail.com|jrafmwvldnpyuceppadd
eivblzaraiaqjsnybzky|eivblzaraiaqjsnybzky@gmail.com|eivblzaraiaqjsnybzky
hnkazmpntbplxkoshuzc|hnkazmpntbplxkoshuzc@gmail.com|hnkazmpntbplxkoshuzc
pbljmzpkynbeuyleygak|pbljmzpkynbeuyleygak@gmail.com|pbljmzpkynbeuyleygak
mkrziuxkgnwewctwctha|mkrziuxkgnwewctwctha@gmail.com|mkrziuxkgnwewctwctha
zyzfzdsxiasxwljmuprr|zyzfzdsxiasxwljmuprr@gmail.com|zyzfzdsxiasxwljmuprr
eghonusrvwwuhhhxagbk|eghonusrvwwuhhhxagbk@gmail.com|eghonusrvwwuhhhxagbk
wsabfamqseplrdhnebjq|wsabfamqseplrdhnebjq@gmail.com|wsabfamqseplrdhnebjq
ncswaspijfrzuwbtlxza|ncswaspijfrzuwbtlxza@gmail.com|ncswaspijfrzuwbtlxza
gmxafqlldqwgfbcpjjgi|gmxafqlldqwgfbcpjjgi@gmail.com|gmxafqlldqwgfbcpjjgi
kwysyfyistenenuntfgy|kwysyfyistenenuntfgy@gmail.com|kwysyfyistenenuntfgy
djqpbrerwotycypkwggy|djqpbrerwotycypkwggy@gmail.com|djqpbrerwotycypkwggy
mcimlcraalmaekacqmvd|mcimlcraalmaekacqmvd@gmail.com|mcimlcraalmaekacqmvd
aukncckjtqrwvguopfbq|aukncckjtqrwvguopfbq@gmail.com|aukncckjtqrwvguopfbq
lnqmqopjqqlxwqgrzkpq|lnqmqopjqqlxwqgrzkpq@gmail.com|lnqmqopjqqlxwqgrzkpq
ucbfacrnbwbajcsjqlew|ucbfacrnbwbajcsjqlew@gmail.com|ucbfacrnbwbajcsjqlew
giydztsazcfbinzxogex|giydztsazcfbinzxogex@gmail.com|giydztsazcfbinzxogex
jsqgbwjqpepclasktbwb|jsqgbwjqpepclasktbwb@gmail.com|jsqgbwjqpepclasktbwb
kvsoaplgmnanaucfiyvt|kvsoaplgmnanaucfiyvt@gmail.com|kvsoaplgmnanaucfiyvt
srsnevbtokaakcoudptm|srsnevbtokaakcoudptm@gmail.com|srsnevbtokaakcoudptm
rvhxyglsrdfkcyytepgr|rvhxyglsrdfkcyytepgr@gmail.com|rvhxyglsrdfkcyytepgr
rnaotbhxgwxfgisewjzx|rnaotbhxgwxfgisewjzx@gmail.com|rnaotbhxgwxfgisewjzx
rnngzfonkhbpdrjgvgxv|rnngzfonkhbpdrjgvgxv@gmail.com|rnngzfonkhbpdrjgvgxv
cwmgafwooapedvnkckge|cwmgafwooapedvnkckge@gmail.com|cwmgafwooapedvnkckge
yuuudvtlesuwmuvhdklt|yuuudvtlesuwmuvhdklt@gmail.com|yuuudvtlesuwmuvhdklt
peerjamngtvofyfuivlj|peerjamngtvofyfuivlj@gmail.com|peerjamngtvofyfuivlj
souqkhwqpsrbgetgqusc|souqkhwqpsrbgetgqusc@gmail.com|souqkhwqpsrbgetgqusc
jullrkzfehfegewrilmd|jullrkzfehfegewrilmd@gmail.com|jullrkzfehfegewrilmd
eeaxtygtzdnmolbaaljt|eeaxtygtzdnmolbaaljt@gmail.com|eeaxtygtzdnmolbaaljt
cuvqwrgbqkanevshymhb|cuvqwrgbqkanevshymhb@gmail.com|cuvqwrgbqkanevshymhb
knkjdiyeseeqdpjmkuvj|knkjdiyeseeqdpjmkuvj@gmail.com|knkjdiyeseeqdpjmkuvj
psrdcfxzreevpokjivps|psrdcfxzreevpokjivps@gmail.com|psrdcfxzreevpokjivps
fyujuvmmkjucrfcgruyb|fyujuvmmkjucrfcgruyb@gmail.com|fyujuvmmkjucrfcgruyb
rqndanczkomvvmufpaun|rqndanczkomvvmufpaun@gmail.com|rqndanczkomvvmufpaun
nreagbqzbnifzhzqykmk|nreagbqzbnifzhzqykmk@gmail.com|nreagbqzbnifzhzqykmk
yatcbsgqspkswttythxe|yatcbsgqspkswttythxe@gmail.com|yatcbsgqspkswttythxe
oiqkwiwiyrouhdlvdmjj|oiqkwiwiyrouhdlvdmjj@gmail.com|oiqkwiwiyrouhdlvdmjj
pfiqducgzxcvuvivudes|pfiqducgzxcvuvivudes@gmail.com|pfiqducgzxcvuvivudes
ivpvtftpwzvexrqqueac|ivpvtftpwzvexrqqueac@gmail.com|ivpvtftpwzvexrqqueac
wduqjikvsjsqruhrciyx|wduqjikvsjsqruhrciyx@gmail.com|wduqjikvsjsqruhrciyx
tcwlpcslryscigyalivj|tcwlpcslryscigyalivj@gmail.com|tcwlpcslryscigyalivj
typknzctisfrmwhodbcq|typknzctisfrmwhodbcq@gmail.com|typknzctisfrmwhodbcq
sxyruzuirqahqfmugqqe|sxyruzuirqahqfmugqqe@gmail.com|sxyruzuirqahqfmugqqe
abtyccopydfnaiozrvca|abtyccopydfnaiozrvca@gmail.com|abtyccopydfnaiozrvca
ojiidbifwattxtvioxog|ojiidbifwattxtvioxog@gmail.com|ojiidbifwattxtvioxog
qbcqwpkfddwbroukpeuj|qbcqwpkfddwbroukpeuj@gmail.com|qbcqwpkfddwbroukpeuj
cidlnmauinqahxgxaxxg|cidlnmauinqahxgxaxxg@gmail.com|cidlnmauinqahxgxaxxg
rikudfkhlumszdonzyfb|rikudfkhlumszdonzyfb@gmail.com|rikudfkhlumszdonzyfb
vhhvoonwrthavvirggup|vhhvoonwrthavvirggup@gmail.com|vhhvoonwrthavvirggup
dmpylgewdkhybbzxjvek|dmpylgewdkhybbzxjvek@gmail.com|dmpylgewdkhybbzxjvek
uenxphztmiaxovdumnsq|uenxphztmiaxovdumnsq@gmail.com|uenxphztmiaxovdumnsq
pccpnujfdzouxiehkqxf|pccpnujfdzouxiehkqxf@gmail.com|pccpnujfdzouxiehkqxf
ebwcuzcdqkxkjhpkjhwv|ebwcuzcdqkxkjhpkjhwv@gmail.com|ebwcuzcdqkxkjhpkjhwv
haxteedoivnubisfffbr|haxteedoivnubisfffbr@gmail.com|haxteedoivnubisfffbr
ydhyohxtcldyftyppspd|ydhyohxtcldyftyppspd@gmail.com|ydhyohxtcldyftyppspd
yzoofeklxhkjevjgqjyn|yzoofeklxhkjevjgqjyn@gmail.com|yzoofeklxhkjevjgqjyn
kccszvazxgklvtzchcim|kccszvazxgklvtzchcim@gmail.com|kccszvazxgklvtzchcim
oxgplfuxbwsiyshumlgn|oxgplfuxbwsiyshumlgn@gmail.com|oxgplfuxbwsiyshumlgn
eullmokbkqdrsmmdvpcu|eullmokbkqdrsmmdvpcu@gmail.com|eullmokbkqdrsmmdvpcu
dscdxfmwaktohccunhsr|dscdxfmwaktohccunhsr@gmail.com|dscdxfmwaktohccunhsr
pxjrfzfrozkrmppvaola|pxjrfzfrozkrmppvaola@gmail.com|pxjrfzfrozkrmppvaola
bdyjdpabnruckvrlqpra|bdyjdpabnruckvrlqpra@gmail.com|bdyjdpabnruckvrlqpra
ehyryxtffiiiexcrjetk|ehyryxtffiiiexcrjetk@gmail.com|ehyryxtffiiiexcrjetk
shykljdzewwqccpxflbc|shykljdzewwqccpxflbc@gmail.com|shykljdzewwqccpxflbc
nvzozodhrrldzmhuqosp|nvzozodhrrldzmhuqosp@gmail.com|nvzozodhrrldzmhuqosp
aartcdmmdxyekjjpcqdf|aartcdmmdxyekjjpcqdf@gmail.com|aartcdmmdxyekjjpcqdf
dyxkmwgxzezhjxmtmkoa|dyxkmwgxzezhjxmtmkoa@gmail.com|dyxkmwgxzezhjxmtmkoa
cwnjdalecygmblsllput|cwnjdalecygmblsllput@gmail.com|cwnjdalecygmblsllput
nlqqscaniyeacmpwqgmt|nlqqscaniyeacmpwqgmt@gmail.com|nlqqscaniyeacmpwqgmt
coljxpzemhlyaxqwjqhx|coljxpzemhlyaxqwjqhx@gmail.com|coljxpzemhlyaxqwjqhx
evdunrskwdraxkmngmmx|evdunrskwdraxkmngmmx@gmail.com|evdunrskwdraxkmngmmx
cumqpmbsxpnlxuwrdtga|cumqpmbsxpnlxuwrdtga@gmail.com|cumqpmbsxpnlxuwrdtga
yxyxdlednewqhwrmgsor|yxyxdlednewqhwrmgsor@gmail.com|yxyxdlednewqhwrmgsor
beqvvnsrztnauwxbyqow|beqvvnsrztnauwxbyqow@gmail.com|beqvvnsrztnauwxbyqow
ikkpyowwqkiggzayvlxd|ikkpyowwqkiggzayvlxd@gmail.com|ikkpyowwqkiggzayvlxd
viaoexgjqrlzcezzsgxb|viaoexgjqrlzcezzsgxb@gmail.com|viaoexgjqrlzcezzsgxb
ilgcdjiwcvjqiyswnbsv|ilgcdjiwcvjqiyswnbsv@gmail.com|ilgcdjiwcvjqiyswnbsv
bdfdutdiyqacnvlkspmx|bdfdutdiyqacnvlkspmx@gmail.com|bdfdutdiyqacnvlkspmx
zxnhmgipoguorpzqdwnr|zxnhmgipoguorpzqdwnr@gmail.com|zxnhmgipoguorpzqdwnr
iwctgkinybppxafohueg|iwctgkinybppxafohueg@gmail.com|iwctgkinybppxafohueg
akynvfecrpzihwhzeczf|akynvfecrpzihwhzeczf@gmail.com|akynvfecrpzihwhzeczf
bttshsnrhhesifknzddn|bttshsnrhhesifknzddn@gmail.com|bttshsnrhhesifknzddn
anawvrtxgqliohyepjrn|anawvrtxgqliohyepjrn@gmail.com|anawvrtxgqliohyepjrn
cvxjeqtndegqrkedgzgu|cvxjeqtndegqrkedgzgu@gmail.com|cvxjeqtndegqrkedgzgu
drxtqvaiipqypbxnjrwj|drxtqvaiipqypbxnjrwj@gmail.com|drxtqvaiipqypbxnjrwj
xaqslqrltbuqieapkuxm|xaqslqrltbuqieapkuxm@gmail.com|xaqslqrltbuqieapkuxm
eyfstpajflxvdvxhzras|eyfstpajflxvdvxhzras@gmail.com|eyfstpajflxvdvxhzras
cvrzaykusbqrpidojkkk|cvrzaykusbqrpidojkkk@gmail.com|cvrzaykusbqrpidojkkk
viodokpeotlexucwnhis|viodokpeotlexucwnhis@gmail.com|viodokpeotlexucwnhis
ffykmglgpurlxndevdew|ffykmglgpurlxndevdew@gmail.com|ffykmglgpurlxndevdew
ojzlbtnilijmrfersoyv|ojzlbtnilijmrfersoyv@gmail.com|ojzlbtnilijmrfersoyv
rbotmkeuyutrrqqsphxl|rbotmkeuyutrrqqsphxl@gmail.com|rbotmkeuyutrrqqsphxl
ybklcvmimptpmwsatkqu|ybklcvmimptpmwsatkqu@gmail.com|ybklcvmimptpmwsatkqu
accojxldiuxqcvvimzrd|accojxldiuxqcvvimzrd@gmail.com|accojxldiuxqcvvimzrd
zzfirripbcclladlnvje|zzfirripbcclladlnvje@gmail.com|zzfirripbcclladlnvje
zqgizqsirxebbamatbyk|zqgizqsirxebbamatbyk@gmail.com|zqgizqsirxebbamatbyk
uoqnflzumvknqczdvkfs|uoqnflzumvknqczdvkfs@gmail.com|uoqnflzumvknqczdvkfs
nidtyruxiolzmgtaykvy|nidtyruxiolzmgtaykvy@gmail.com|nidtyruxiolzmgtaykvy
yztnptmpiztzvnbxuqji|yztnptmpiztzvnbxuqji@gmail.com|yztnptmpiztzvnbxuqji
zoozwdhltornqdkikccy|zoozwdhltornqdkikccy@gmail.com|zoozwdhltornqdkikccy
nsxkywikexhaehbtpuqc|nsxkywikexhaehbtpuqc@gmail.com|nsxkywikexhaehbtpuqc
voahuhwewxmpqybuiwjo|voahuhwewxmpqybuiwjo@gmail.com|voahuhwewxmpqybuiwjo
xsxxnpdstlacbtcrttaf|xsxxnpdstlacbtcrttaf@gmail.com|xsxxnpdstlacbtcrttaf
ubxvjofsyetzmvugeljc|ubxvjofsyetzmvugeljc@gmail.com|ubxvjofsyetzmvugeljc
eicbznvbptyazldzvbzg|eicbznvbptyazldzvbzg@gmail.com|eicbznvbptyazldzvbzg
osiyszogxkwanxjmobwd|osiyszogxkwanxjmobwd@gmail.com|osiyszogxkwanxjmobwd
knswfxajrfhvyebejgqd|knswfxajrfhvyebejgqd@gmail.com|knswfxajrfhvyebejgqd
kaawsvcqbwhgiqcimdnq|kaawsvcqbwhgiqcimdnq@gmail.com|kaawsvcqbwhgiqcimdnq
obiqbsgszmaatecnjteo|obiqbsgszmaatecnjteo@gmail.com|obiqbsgszmaatecnjteo
zylqkrarqehlocsianky|zylqkrarqehlocsianky@gmail.com|zylqkrarqehlocsianky
ltymmakyffmciplvzfev|ltymmakyffmciplvzfev@gmail.com|ltymmakyffmciplvzfev
xnkfaxzmpysngbxjxhby|xnkfaxzmpysngbxjxhby@gmail.com|xnkfaxzmpysngbxjxhby
ovizztihnngunxwpvufg|ovizztihnngunxwpvufg@gmail.com|ovizztihnngunxwpvufg
xfnbzrysdwsyiagcmdhr|xfnbzrysdwsyiagcmdhr@gmail.com|xfnbzrysdwsyiagcmdhr
xlpcrqsapqxnxokekzyj|xlpcrqsapqxnxokekzyj@gmail.com|xlpcrqsapqxnxokekzyj
vtvgdnohwdozcrpqnzjx|vtvgdnohwdozcrpqnzjx@gmail.com|vtvgdnohwdozcrpqnzjx
hsknbfqdmwzbjcpdjfmx|hsknbfqdmwzbjcpdjfmx@gmail.com|hsknbfqdmwzbjcpdjfmx
jjtgwtftbttididsfvuq|jjtgwtftbttididsfvuq@gmail.com|jjtgwtftbttididsfvuq
zpbguvfqeiqzzvgvdnfv|zpbguvfqeiqzzvgvdnfv@gmail.com|zpbguvfqeiqzzvgvdnfv
zhsqrrcjhxaougcjhpsf|zhsqrrcjhxaougcjhpsf@gmail.com|zhsqrrcjhxaougcjhpsf
haasxroljyehinuayvse|haasxroljyehinuayvse@gmail.com|haasxroljyehinuayvse
rmpgguumiklfukjrmvpf|rmpgguumiklfukjrmvpf@gmail.com|rmpgguumiklfukjrmvpf
tmqbpaorxugvkugiaasn|tmqbpaorxugvkugiaasn@gmail.com|tmqbpaorxugvkugiaasn
osytmfoyybttiitdqnjv|osytmfoyybttiitdqnjv@gmail.com|osytmfoyybttiitdqnjv
ltvheztjaxwpxtndyake|ltvheztjaxwpxtndyake@gmail.com|ltvheztjaxwpxtndyake
zynpnapniayzdqjbpkeh|zynpnapniayzdqjbpkeh@gmail.com|zynpnapniayzdqjbpkeh
rckjhfvungxejfnkssba|rckjhfvungxejfnkssba@gmail.com|rckjhfvungxejfnkssba
buhhojeotqykfiuxqnax|buhhojeotqykfiuxqnax@gmail.com|buhhojeotqykfiuxqnax
ecmphaptahmybkoganjg|ecmphaptahmybkoganjg@gmail.com|ecmphaptahmybkoganjg
etbssblsnoaywtulwfec|etbssblsnoaywtulwfec@gmail.com|etbssblsnoaywtulwfec
klpulzydsgjmicwlrujt|klpulzydsgjmicwlrujt@gmail.com|klpulzydsgjmicwlrujt
rcteecvdvlmaapwusukv|rcteecvdvlmaapwusukv@gmail.com|rcteecvdvlmaapwusukv
hnwfsihyejfrnjwngoxy|hnwfsihyejfrnjwngoxy@gmail.com|hnwfsihyejfrnjwngoxy
tlucdetxdgftwkmeqaar|tlucdetxdgftwkmeqaar@gmail.com|tlucdetxdgftwkmeqaar
dxgnwduztpvlqznglaww|dxgnwduztpvlqznglaww@gmail.com|dxgnwduztpvlqznglaww
hnyvijbutpmdxqctukzm|hnyvijbutpmdxqctukzm@gmail.com|hnyvijbutpmdxqctukzm
psvpqrlrfrlgcevmngcj|psvpqrlrfrlgcevmngcj@gmail.com|psvpqrlrfrlgcevmngcj
ecjfjgyzgfpngtqltxgm|ecjfjgyzgfpngtqltxgm@gmail.com|ecjfjgyzgfpngtqltxgm
tmqgujyyoopahqsbpcyh|tmqgujyyoopahqsbpcyh@gmail.com|tmqgujyyoopahqsbpcyh
equgwkwrtvoxujrlujjt|equgwkwrtvoxujrlujjt@gmail.com|equgwkwrtvoxujrlujjt
nsqjhsteafhlulhiyync|nsqjhsteafhlulhiyync@gmail.com|nsqjhsteafhlulhiyync
kewhekcbojaddozndazj|kewhekcbojaddozndazj@gmail.com|kewhekcbojaddozndazj
yyejlcuumjvuejyxwkgl|yyejlcuumjvuejyxwkgl@gmail.com|yyejlcuumjvuejyxwkgl
cquxtrfmzfjpgzrprhwo|cquxtrfmzfjpgzrprhwo@gmail.com|cquxtrfmzfjpgzrprhwo
swhoyfstvjaymkeucuoj|swhoyfstvjaymkeucuoj@gmail.com|swhoyfstvjaymkeucuoj
riytgbunjhxtlckbygzb|riytgbunjhxtlckbygzb@gmail.com|riytgbunjhxtlckbygzb
plfpmijezkiuxjquglad|plfpmijezkiuxjquglad@gmail.com|plfpmijezkiuxjquglad
vlahdxxkqpoghkewgvfw|vlahdxxkqpoghkewgvfw@gmail.com|vlahdxxkqpoghkewgvfw
khmynmupjnmcyuhidowv|khmynmupjnmcyuhidowv@gmail.com|khmynmupjnmcyuhidowv
bmveatosnczfuioxoicr|bmveatosnczfuioxoicr@gmail.com|bmveatosnczfuioxoicr
koutvnmhbmdlfhfiqxmd|koutvnmhbmdlfhfiqxmd@gmail.com|koutvnmhbmdlfhfiqxmd
ktjswvtzdxgvrbhuivtu|ktjswvtzdxgvrbhuivtu@gmail.com|ktjswvtzdxgvrbhuivtu
vutcitatwexapolmeyrx|vutcitatwexapolmeyrx@gmail.com|vutcitatwexapolmeyrx
einhysbmujygcyzupnap|einhysbmujygcyzupnap@gmail.com|einhysbmujygcyzupnap
tmxxeqcpvgetdolvjllo|tmxxeqcpvgetdolvjllo@gmail.com|tmxxeqcpvgetdolvjllo
jpzvemxtgismuavdudsq|jpzvemxtgismuavdudsq@gmail.com|jpzvemxtgismuavdudsq
ebxyxyxhdfawoicvkdsg|ebxyxyxhdfawoicvkdsg@gmail.com|ebxyxyxhdfawoicvkdsg
iunofybsztthuhnfhldv|iunofybsztthuhnfhldv@gmail.com|iunofybsztthuhnfhldv
dpvbjvrqilmmhlbncozi|dpvbjvrqilmmhlbncozi@gmail.com|dpvbjvrqilmmhlbncozi
vhesdtmnaxxtrhywmuac|vhesdtmnaxxtrhywmuac@gmail.com|vhesdtmnaxxtrhywmuac
hixllsjhvdkrfgujannw|hixllsjhvdkrfgujannw@gmail.com|hixllsjhvdkrfgujannw
zhgxgcxasyixatupriad|zhgxgcxasyixatupriad@gmail.com|zhgxgcxasyixatupriad
yixzqelmtdhgaauryles|yixzqelmtdhgaauryles@gmail.com|yixzqelmtdhgaauryles
ptydlmhfqyzrwvzimfiy|ptydlmhfqyzrwvzimfiy@gmail.com|ptydlmhfqyzrwvzimfiy
xqeuhplmhaflizwwjoql|xqeuhplmhaflizwwjoql@gmail.com|xqeuhplmhaflizwwjoql
cgbvqmgqfocxhjwwndob|cgbvqmgqfocxhjwwndob@gmail.com|cgbvqmgqfocxhjwwndob
ivmtbvtmsvplpsnnwgjs|ivmtbvtmsvplpsnnwgjs@gmail.com|ivmtbvtmsvplpsnnwgjs
xtzhqjbyqdpjksqguqcd|xtzhqjbyqdpjksqguqcd@gmail.com|xtzhqjbyqdpjksqguqcd
xsilvsiltbaqvcbhqpcu|xsilvsiltbaqvcbhqpcu@gmail.com|xsilvsiltbaqvcbhqpcu
eedcbcpafdajocxdlkur|eedcbcpafdajocxdlkur@gmail.com|eedcbcpafdajocxdlkur
dinueeuvzqgbhnxqdxig|dinueeuvzqgbhnxqdxig@gmail.com|dinueeuvzqgbhnxqdxig
kgakxxqowogrwcfozeid|kgakxxqowogrwcfozeid@gmail.com|kgakxxqowogrwcfozeid
dfzpeczxdsfyqzeueynw|dfzpeczxdsfyqzeueynw@gmail.com|dfzpeczxdsfyqzeueynw
sfihmfnkrxleasqlboip|sfihmfnkrxleasqlboip@gmail.com|sfihmfnkrxleasqlboip
gqxvalrqnxtdjccwgnse|gqxvalrqnxtdjccwgnse@gmail.com|gqxvalrqnxtdjccwgnse
pkygvndfjgfkvdssfyez|pkygvndfjgfkvdssfyez@gmail.com|pkygvndfjgfkvdssfyez
blzjzvfnppiveatdwlwz|blzjzvfnppiveatdwlwz@gmail.com|blzjzvfnppiveatdwlwz
xorluhnjglgpsosmcwuj|xorluhnjglgpsosmcwuj@gmail.com|xorluhnjglgpsosmcwuj
zomqmrfrdwfipgaltgbk|zomqmrfrdwfipgaltgbk@gmail.com|zomqmrfrdwfipgaltgbk
buayccvybptnadgdxxeh|buayccvybptnadgdxxeh@gmail.com|buayccvybptnadgdxxeh
qwjavlfxanyepvdfbebz|qwjavlfxanyepvdfbebz@gmail.com|qwjavlfxanyepvdfbebz
omnqkcvzxkqrlwknxaqg|omnqkcvzxkqrlwknxaqg@gmail.com|omnqkcvzxkqrlwknxaqg
diwcrheytyvxarfsxiob|diwcrheytyvxarfsxiob@gmail.com|diwcrheytyvxarfsxiob
lgfytgqnajxbhzhyhlmt|lgfytgqnajxbhzhyhlmt@gmail.com|lgfytgqnajxbhzhyhlmt
roosfttrthrrnccbuzft|roosfttrthrrnccbuzft@gmail.com|roosfttrthrrnccbuzft
mfqufurjqdrtvrflbuws|mfqufurjqdrtvrflbuws@gmail.com|mfqufurjqdrtvrflbuws
xgpcvuyqfqzvyompljsc|xgpcvuyqfqzvyompljsc@gmail.com|xgpcvuyqfqzvyompljsc
pkbrztoguxkhhdrdtbaw|pkbrztoguxkhhdrdtbaw@gmail.com|pkbrztoguxkhhdrdtbaw
kbtahxkuffzmtxejioeu|kbtahxkuffzmtxejioeu@gmail.com|kbtahxkuffzmtxejioeu
ngxrnudxbocqsjbyexgh|ngxrnudxbocqsjbyexgh@gmail.com|ngxrnudxbocqsjbyexgh
kcbfvbfzllumhlbhypqu|kcbfvbfzllumhlbhypqu@gmail.com|kcbfvbfzllumhlbhypqu
wvbofintawqqsjthxkpw|wvbofintawqqsjthxkpw@gmail.com|wvbofintawqqsjthxkpw
ffnldmeaewqcjqbnwmdq|ffnldmeaewqcjqbnwmdq@gmail.com|ffnldmeaewqcjqbnwmdq
pqzuzevdrejdabheqvdr|pqzuzevdrejdabheqvdr@gmail.com|pqzuzevdrejdabheqvdr
gjkwvvibbsexotogeuvo|gjkwvvibbsexotogeuvo@gmail.com|gjkwvvibbsexotogeuvo
hghkmzjreahpmgkbxdoh|hghkmzjreahpmgkbxdoh@gmail.com|hghkmzjreahpmgkbxdoh
vtnjjcjsbcyctdoocujz|vtnjjcjsbcyctdoocujz@gmail.com|vtnjjcjsbcyctdoocujz
czkxvscvnexfmavbywla|czkxvscvnexfmavbywla@gmail.com|czkxvscvnexfmavbywla
lkppwrksycksovrfxequ|lkppwrksycksovrfxequ@gmail.com|lkppwrksycksovrfxequ
horerayjfweitqamuorx|horerayjfweitqamuorx@gmail.com|horerayjfweitqamuorx
fjzkctyxdscyymixochy|fjzkctyxdscyymixochy@gmail.com|fjzkctyxdscyymixochy
crsizfbsuecefzpokykp|crsizfbsuecefzpokykp@gmail.com|crsizfbsuecefzpokykp
ltfbxhesouleokulsibk|ltfbxhesouleokulsibk@gmail.com|ltfbxhesouleokulsibk
otisornwilijyfmxuqks|otisornwilijyfmxuqks@gmail.com|otisornwilijyfmxuqks
fasyoyqihgncnuwkzfke|fasyoyqihgncnuwkzfke@gmail.com|fasyoyqihgncnuwkzfke
jmmbofricfoqjtizhrhj|jmmbofricfoqjtizhrhj@gmail.com|jmmbofricfoqjtizhrhj
yodwpsxnpltoxswnstfb|yodwpsxnpltoxswnstfb@gmail.com|yodwpsxnpltoxswnstfb
newrmppszcplezfqrpyo|newrmppszcplezfqrpyo@gmail.com|newrmppszcplezfqrpyo
gjqfxpizjmfizgoprzxo|gjqfxpizjmfizgoprzxo@gmail.com|gjqfxpizjmfizgoprzxo
qirqnecdusjavrppcvnt|qirqnecdusjavrppcvnt@gmail.com|qirqnecdusjavrppcvnt
yzgbzgxjinntdhpmperj|yzgbzgxjinntdhpmperj@gmail.com|yzgbzgxjinntdhpmperj
fypwujsxpaknsejdjvrb|fypwujsxpaknsejdjvrb@gmail.com|fypwujsxpaknsejdjvrb
ytaopfagjjwxvithslom|ytaopfagjjwxvithslom@gmail.com|ytaopfagjjwxvithslom
ikjvmsupnekpmcywxzwq|ikjvmsupnekpmcywxzwq@gmail.com|ikjvmsupnekpmcywxzwq
wpfxdmgdvrvuxtiruuhu|wpfxdmgdvrvuxtiruuhu@gmail.com|wpfxdmgdvrvuxtiruuhu
kiezrpqnimxojfuukupd|kiezrpqnimxojfuukupd@gmail.com|kiezrpqnimxojfuukupd
clqdwvubxmuhuzcmezok|clqdwvubxmuhuzcmezok@gmail.com|clqdwvubxmuhuzcmezok
ssdcogtdyyabodzjnkjs|ssdcogtdyyabodzjnkjs@gmail.com|ssdcogtdyyabodzjnkjs
iaewsixeuacrcivllzne|iaewsixeuacrcivllzne@gmail.com|iaewsixeuacrcivllzne
kpnnspmbkrjtalidvdko|kpnnspmbkrjtalidvdko@gmail.com|kpnnspmbkrjtalidvdko
gdaqaqorrcpuumbkwoob|gdaqaqorrcpuumbkwoob@gmail.com|gdaqaqorrcpuumbkwoob
dtiiijejubihzquewpvj|dtiiijejubihzquewpvj@gmail.com|dtiiijejubihzquewpvj
awhgxvqsdholhdsndugn|awhgxvqsdholhdsndugn@gmail.com|awhgxvqsdholhdsndugn
qzqhyvwvotmpepezdhbi|qzqhyvwvotmpepezdhbi@gmail.com|qzqhyvwvotmpepezdhbi
kutzjcfhkanebogragtn|kutzjcfhkanebogragtn@gmail.com|kutzjcfhkanebogragtn
lnbvhgdqdckilpaqhgtx|lnbvhgdqdckilpaqhgtx@gmail.com|lnbvhgdqdckilpaqhgtx
tijemgnhwuvxicxaxbns|tijemgnhwuvxicxaxbns@gmail.com|tijemgnhwuvxicxaxbns
inavuylramqaeodwoqwf|inavuylramqaeodwoqwf@gmail.com|inavuylramqaeodwoqwf
vjoqysmhlpphoppfwkub|vjoqysmhlpphoppfwkub@gmail.com|vjoqysmhlpphoppfwkub
xncggqozebplbqbqfkdx|xncggqozebplbqbqfkdx@gmail.com|xncggqozebplbqbqfkdx
pdkhlimezvkrtmjdajcs|pdkhlimezvkrtmjdajcs@gmail.com|pdkhlimezvkrtmjdajcs
ceqynagrizmlsmbvkkug|ceqynagrizmlsmbvkkug@gmail.com|ceqynagrizmlsmbvkkug
zuzmvwpiamfyzknlxxtl|zuzmvwpiamfyzknlxxtl@gmail.com|zuzmvwpiamfyzknlxxtl
sztlgfekeajbgxndbstv|sztlgfekeajbgxndbstv@gmail.com|sztlgfekeajbgxndbstv
xqrwkaazubcadhyiiyiy|xqrwkaazubcadhyiiyiy@gmail.com|xqrwkaazubcadhyiiyiy
levshokgpboalymfywei|levshokgpboalymfywei@gmail.com|levshokgpboalymfywei
kipeksvdferscojsncoh|kipeksvdferscojsncoh@gmail.com|kipeksvdferscojsncoh
kpkpsginhoyxazyszynr|kpkpsginhoyxazyszynr@gmail.com|kpkpsginhoyxazyszynr
wmtgqiksjdtngtpbjjmj|wmtgqiksjdtngtpbjjmj@gmail.com|wmtgqiksjdtngtpbjjmj
vmnnkwkwmfparakzwino|vmnnkwkwmfparakzwino@gmail.com|vmnnkwkwmfparakzwino
amkmhyoicwblbtiwlpfd|amkmhyoicwblbtiwlpfd@gmail.com|amkmhyoicwblbtiwlpfd
bnvcwxsfaerazcgvniqs|bnvcwxsfaerazcgvniqs@gmail.com|bnvcwxsfaerazcgvniqs
txldtqebpggwgpuffkao|txldtqebpggwgpuffkao@gmail.com|txldtqebpggwgpuffkao
busdzxsjtyjhntsjjryy|busdzxsjtyjhntsjjryy@gmail.com|busdzxsjtyjhntsjjryy
bfmimlkxbbmzmdmywomr|bfmimlkxbbmzmdmywomr@gmail.com|bfmimlkxbbmzmdmywomr
divagihhzrmjujwaxooc|divagihhzrmjujwaxooc@gmail.com|divagihhzrmjujwaxooc
fxlzdmfencocrixfirhr|fxlzdmfencocrixfirhr@gmail.com|fxlzdmfencocrixfirhr
uqglxobqtueqtwdzhtkb|uqglxobqtueqtwdzhtkb@gmail.com|uqglxobqtueqtwdzhtkb
mubcnazrixzdlbfhrnhn|mubcnazrixzdlbfhrnhn@gmail.com|mubcnazrixzdlbfhrnhn
slyrylrzbgejhmgkmrvt|slyrylrzbgejhmgkmrvt@gmail.com|slyrylrzbgejhmgkmrvt
kullhpdoswbbgivslbet|kullhpdoswbbgivslbet@gmail.com|kullhpdoswbbgivslbet
txryfnrsxamhdtehbfkl|txryfnrsxamhdtehbfkl@gmail.com|txryfnrsxamhdtehbfkl
eofvreozntlxtzklmtlu|eofvreozntlxtzklmtlu@gmail.com|eofvreozntlxtzklmtlu
fqyyarpmweybbipdhspq|fqyyarpmweybbipdhspq@gmail.com|fqyyarpmweybbipdhspq
rrjncfndfcdqfelxhxdd|rrjncfndfcdqfelxhxdd@gmail.com|rrjncfndfcdqfelxhxdd
rduwowcrpynjtqutqzaq|rduwowcrpynjtqutqzaq@gmail.com|rduwowcrpynjtqutqzaq
inlgbrljnirmnwqxahbz|inlgbrljnirmnwqxahbz@gmail.com|inlgbrljnirmnwqxahbz
chgwenodegdmunsoktrx|chgwenodegdmunsoktrx@gmail.com|chgwenodegdmunsoktrx
cxpfmujetggowsfxswpp|cxpfmujetggowsfxswpp@gmail.com|cxpfmujetggowsfxswpp
emcnpgzidxzdfrezstfm|emcnpgzidxzdfrezstfm@gmail.com|emcnpgzidxzdfrezstfm
orbjjalkuxacvdkijjot|orbjjalkuxacvdkijjot@gmail.com|orbjjalkuxacvdkijjot
rhdpctkyvjtifskxhrsv|rhdpctkyvjtifskxhrsv@gmail.com|rhdpctkyvjtifskxhrsv
cckvozujkpwhyqmeiuhh|cckvozujkpwhyqmeiuhh@gmail.com|cckvozujkpwhyqmeiuhh
xncvxrdpbikvaszxayca|xncvxrdpbikvaszxayca@gmail.com|xncvxrdpbikvaszxayca
zpbehmvcdyynwqruqqah|zpbehmvcdyynwqruqqah@gmail.com|zpbehmvcdyynwqruqqah
eksklgdfitwgibytoseh|eksklgdfitwgibytoseh@gmail.com|eksklgdfitwgibytoseh
oucjznxgvkvdibxpfxbw|oucjznxgvkvdibxpfxbw@gmail.com|oucjznxgvkvdibxpfxbw
yrxlmbpnleqidfivfaks|yrxlmbpnleqidfivfaks@gmail.com|yrxlmbpnleqidfivfaks
toyluboscurkbazazjlg|toyluboscurkbazazjlg@gmail.com|toyluboscurkbazazjlg
gfubkziobsewydpunxzd|gfubkziobsewydpunxzd@gmail.com|gfubkziobsewydpunxzd
puekharwlhmvvepagorx|puekharwlhmvvepagorx@gmail.com|puekharwlhmvvepagorx
yduiufsryutqfqjgiqdo|yduiufsryutqfqjgiqdo@gmail.com|yduiufsryutqfqjgiqdo
xjhpurcladutdmqsrjoz|xjhpurcladutdmqsrjoz@gmail.com|xjhpurcladutdmqsrjoz
ivnfqgwbccxvuvcjzmvq|ivnfqgwbccxvuvcjzmvq@gmail.com|ivnfqgwbccxvuvcjzmvq
nxikfbggszvkaeuguajn|nxikfbggszvkaeuguajn@gmail.com|nxikfbggszvkaeuguajn
bwmogckcwnaefbcjhfij|bwmogckcwnaefbcjhfij@gmail.com|bwmogckcwnaefbcjhfij
ryoqqrjlpluoklbggmwj|ryoqqrjlpluoklbggmwj@gmail.com|ryoqqrjlpluoklbggmwj
qqfrzhtbplnxsdgqqoxz|qqfrzhtbplnxsdgqqoxz@gmail.com|qqfrzhtbplnxsdgqqoxz
llnqrogkmerhdhyskcxa|llnqrogkmerhdhyskcxa@gmail.com|llnqrogkmerhdhyskcxa
rqbtfyseiumfjkgfgrnf|rqbtfyseiumfjkgfgrnf@gmail.com|rqbtfyseiumfjkgfgrnf
bqmvngulhyniacvnijjh|bqmvngulhyniacvnijjh@gmail.com|bqmvngulhyniacvnijjh
vdnygrfsmtynqkytjllv|vdnygrfsmtynqkytjllv@gmail.com|vdnygrfsmtynqkytjllv
hvuxiavjrjzlmsuogzvh|hvuxiavjrjzlmsuogzvh@gmail.com|hvuxiavjrjzlmsuogzvh
gyyqjlumiaieluegiryy|gyyqjlumiaieluegiryy@gmail.com|gyyqjlumiaieluegiryy
jxwtmgpcwqreihjdrqay|jxwtmgpcwqreihjdrqay@gmail.com|jxwtmgpcwqreihjdrqay
nrzxsrxodtgrvomareap|nrzxsrxodtgrvomareap@gmail.com|nrzxsrxodtgrvomareap
cnbbeuqkoceiplvscgvc|cnbbeuqkoceiplvscgvc@gmail.com|cnbbeuqkoceiplvscgvc
kdxrcltkrbjsxgylliwm|kdxrcltkrbjsxgylliwm@gmail.com|kdxrcltkrbjsxgylliwm
bjlkkynoqmmeumuuairm|bjlkkynoqmmeumuuairm@gmail.com|bjlkkynoqmmeumuuairm
rssyligjfbvcjiukimqo|rssyligjfbvcjiukimqo@gmail.com|rssyligjfbvcjiukimqo
wwmubuflvczqndejntfl|wwmubuflvczqndejntfl@gmail.com|wwmubuflvczqndejntfl
vedunrhsvbyjpjbdhhos|vedunrhsvbyjpjbdhhos@gmail.com|vedunrhsvbyjpjbdhhos
hfwhrtblgzfzstnxyjti|hfwhrtblgzfzstnxyjti@gmail.com|hfwhrtblgzfzstnxyjti
lkeqsqhfsksvvrvjeaxo|lkeqsqhfsksvvrvjeaxo@gmail.com|lkeqsqhfsksvvrvjeaxo
nfabzkumwegrniubmpfg|nfabzkumwegrniubmpfg@gmail.com|nfabzkumwegrniubmpfg
crdpuhitlnnufygsixlo|crdpuhitlnnufygsixlo@gmail.com|crdpuhitlnnufygsixlo
fzysbfqnvvxtnmhuzjvh|fzysbfqnvvxtnmhuzjvh@gmail.com|fzysbfqnvvxtnmhuzjvh
vnupiwdhwchtahrhgraa|vnupiwdhwchtahrhgraa@gmail.com|vnupiwdhwchtahrhgraa
etxbhlyppksmeqdwuoow|etxbhlyppksmeqdwuoow@gmail.com|etxbhlyppksmeqdwuoow
jnosbbcdarvdzaexwczl|jnosbbcdarvdzaexwczl@gmail.com|jnosbbcdarvdzaexwczl
mtqomuqdhlpwjfjkzcbm|mtqomuqdhlpwjfjkzcbm@gmail.com|mtqomuqdhlpwjfjkzcbm
jodfcadfhvzxtwnquacv|jodfcadfhvzxtwnquacv@gmail.com|jodfcadfhvzxtwnquacv
dmhnxhxhuifhygusimvi|dmhnxhxhuifhygusimvi@gmail.com|dmhnxhxhuifhygusimvi
dunlsydifyuvckemshyo|dunlsydifyuvckemshyo@gmail.com|dunlsydifyuvckemshyo
dylrvnwfeodwqveiinvr|dylrvnwfeodwqveiinvr@gmail.com|dylrvnwfeodwqveiinvr
jlpjuhtoftullkoairmh|jlpjuhtoftullkoairmh@gmail.com|jlpjuhtoftullkoairmh
jtavrcshjloxikdeasvl|jtavrcshjloxikdeasvl@gmail.com|jtavrcshjloxikdeasvl
xalstnpcrilerzwzeist|xalstnpcrilerzwzeist@gmail.com|xalstnpcrilerzwzeist
fipahcbdvoiekeezhyeh|fipahcbdvoiekeezhyeh@gmail.com|fipahcbdvoiekeezhyeh
hfkqwhvjzndnyjgdtbhi|hfkqwhvjzndnyjgdtbhi@gmail.com|hfkqwhvjzndnyjgdtbhi
dulyvqglccucmwinownb|dulyvqglccucmwinownb@gmail.com|dulyvqglccucmwinownb
zolydpbkjctzgcasafkq|zolydpbkjctzgcasafkq@gmail.com|zolydpbkjctzgcasafkq
qdpocspdnqwdgjuwdiqy|qdpocspdnqwdgjuwdiqy@gmail.com|qdpocspdnqwdgjuwdiqy
sgqsvrtjeujdawkyjxhq|sgqsvrtjeujdawkyjxhq@gmail.com|sgqsvrtjeujdawkyjxhq
obpmgpamwnbxxyubtcvu|obpmgpamwnbxxyubtcvu@gmail.com|obpmgpamwnbxxyubtcvu
nxdjzssbyoykycdlgifl|nxdjzssbyoykycdlgifl@gmail.com|nxdjzssbyoykycdlgifl
yaykpfawuczbtbvqovfr|yaykpfawuczbtbvqovfr@gmail.com|yaykpfawuczbtbvqovfr
lwgfewlkatzjtpbahsjk|lwgfewlkatzjtpbahsjk@gmail.com|lwgfewlkatzjtpbahsjk
mxclegeouculmpfjifor|mxclegeouculmpfjifor@gmail.com|mxclegeouculmpfjifor
fxreqxfksxrnvlznmhfm|fxreqxfksxrnvlznmhfm@gmail.com|fxreqxfksxrnvlznmhfm
ulimnrobpvirydylgdqu|ulimnrobpvirydylgdqu@gmail.com|ulimnrobpvirydylgdqu
spdaxiqrnskwzkfkccbb|spdaxiqrnskwzkfkccbb@gmail.com|spdaxiqrnskwzkfkccbb
vobbkuixwdeyfkeqglxy|vobbkuixwdeyfkeqglxy@gmail.com|vobbkuixwdeyfkeqglxy
oxwlvopligiuifkygdww|oxwlvopligiuifkygdww@gmail.com|oxwlvopligiuifkygdww
vbczmeznwnuglyvgepnj|vbczmeznwnuglyvgepnj@gmail.com|vbczmeznwnuglyvgepnj
pzrbunzqthghbsvgesbk|pzrbunzqthghbsvgesbk@gmail.com|pzrbunzqthghbsvgesbk
hiqpturzqacymgouqsge|hiqpturzqacymgouqsge@gmail.com|hiqpturzqacymgouqsge
fjotxungouefqxwoeqxq|fjotxungouefqxwoeqxq@gmail.com|fjotxungouefqxwoeqxq
lbvktlbfvifpnejvunkf|lbvktlbfvifpnejvunkf@gmail.com|lbvktlbfvifpnejvunkf
kqfikrrswxmduzkgkebz|kqfikrrswxmduzkgkebz@gmail.com|kqfikrrswxmduzkgkebz
qgatbbxwmmytxxuadmxx|qgatbbxwmmytxxuadmxx@gmail.com|qgatbbxwmmytxxuadmxx
wgvvxfnnfhkpfuuemcjh|wgvvxfnnfhkpfuuemcjh@gmail.com|wgvvxfnnfhkpfuuemcjh
invyiqludpohreyorhbs|invyiqludpohreyorhbs@gmail.com|invyiqludpohreyorhbs
pdftoqnjzbvzrpaygcgq|pdftoqnjzbvzrpaygcgq@gmail.com|pdftoqnjzbvzrpaygcgq
chyizxgsyglelcmecgcl|chyizxgsyglelcmecgcl@gmail.com|chyizxgsyglelcmecgcl
wbvemfxcwdfxwvhozloi|wbvemfxcwdfxwvhozloi@gmail.com|wbvemfxcwdfxwvhozloi
fonrvxopxdivtxmxszsc|fonrvxopxdivtxmxszsc@gmail.com|fonrvxopxdivtxmxszsc
dwviyefrteuxkaavtqay|dwviyefrteuxkaavtqay@gmail.com|dwviyefrteuxkaavtqay
rfhuxiahiqxkhjssnret|rfhuxiahiqxkhjssnret@gmail.com|rfhuxiahiqxkhjssnret
qscaqqhmwgpuouorvrio|qscaqqhmwgpuouorvrio@gmail.com|qscaqqhmwgpuouorvrio
ahccabdpysyoxpvdypym|ahccabdpysyoxpvdypym@gmail.com|ahccabdpysyoxpvdypym
kzzojndtxgvvpuegikyt|kzzojndtxgvvpuegikyt@gmail.com|kzzojndtxgvvpuegikyt
cibgdeavwhfdubfjbhia|cibgdeavwhfdubfjbhia@gmail.com|cibgdeavwhfdubfjbhia
wlpzrxrnuxwmptjbwxpl|wlpzrxrnuxwmptjbwxpl@gmail.com|wlpzrxrnuxwmptjbwxpl
innqpdlblkchqxtpkmux|innqpdlblkchqxtpkmux@gmail.com|innqpdlblkchqxtpkmux
hmubdahrpwrfaesfxxhs|hmubdahrpwrfaesfxxhs@gmail.com|hmubdahrpwrfaesfxxhs
fxfhkahfbnrhafgutted|fxfhkahfbnrhafgutted@gmail.com|fxfhkahfbnrhafgutted
ygfbanrzadlceckairvr|ygfbanrzadlceckairvr@gmail.com|ygfbanrzadlceckairvr
bgqfecahajcsmatzsjhw|bgqfecahajcsmatzsjhw@gmail.com|bgqfecahajcsmatzsjhw
qwywjvzimehezdnjkvyg|qwywjvzimehezdnjkvyg@gmail.com|qwywjvzimehezdnjkvyg
kgditnmyboyhjpgdnqiw|kgditnmyboyhjpgdnqiw@gmail.com|kgditnmyboyhjpgdnqiw
eiqrfppwtafcuxkomrie|eiqrfppwtafcuxkomrie@gmail.com|eiqrfppwtafcuxkomrie
malfpymwasdftahrkzoy|malfpymwasdftahrkzoy@gmail.com|malfpymwasdftahrkzoy
qlrpexgfcrbqrenhyoiw|qlrpexgfcrbqrenhyoiw@gmail.com|qlrpexgfcrbqrenhyoiw
julnvkbikccewcxwwdmx|julnvkbikccewcxwwdmx@gmail.com|julnvkbikccewcxwwdmx
iljjbimriztndebilnzu|iljjbimriztndebilnzu@gmail.com|iljjbimriztndebilnzu
jeegsolamaovcfoofvat|jeegsolamaovcfoofvat@gmail.com|jeegsolamaovcfoofvat
hbhzquicoxpifayqnlhk|hbhzquicoxpifayqnlhk@gmail.com|hbhzquicoxpifayqnlhk
bvzyffmvgxuoygoxfyam|bvzyffmvgxuoygoxfyam@gmail.com|bvzyffmvgxuoygoxfyam
kjdesalrwatjxofsfqxn|kjdesalrwatjxofsfqxn@gmail.com|kjdesalrwatjxofsfqxn
qskygiryviydsinhqfse|qskygiryviydsinhqfse@gmail.com|qskygiryviydsinhqfse
uvioqatgbotwwrkbiaky|uvioqatgbotwwrkbiaky@gmail.com|uvioqatgbotwwrkbiaky
lybhfqgtyihgejubotfu|lybhfqgtyihgejubotfu@gmail.com|lybhfqgtyihgejubotfu
zdrtaljuyqrbqckqwdea|zdrtaljuyqrbqckqwdea@gmail.com|zdrtaljuyqrbqckqwdea
oshbxmzmlobpdoumwyes|oshbxmzmlobpdoumwyes@gmail.com|oshbxmzmlobpdoumwyes
hvfqlbdnrwuibolkwlho|hvfqlbdnrwuibolkwlho@gmail.com|hvfqlbdnrwuibolkwlho
yscrrbjyfukrvcwzvtou|yscrrbjyfukrvcwzvtou@gmail.com|yscrrbjyfukrvcwzvtou
fndqzoufbosxddcilzne|fndqzoufbosxddcilzne@gmail.com|fndqzoufbosxddcilzne
vxkkfdakihtmpushmwzj|vxkkfdakihtmpushmwzj@gmail.com|vxkkfdakihtmpushmwzj
xugfrzyfrynmcfjjynml|xugfrzyfrynmcfjjynml@gmail.com|xugfrzyfrynmcfjjynml
lqjowdudyckqhwyzwplw|lqjowdudyckqhwyzwplw@gmail.com|lqjowdudyckqhwyzwplw
ezhiyurdjgukwixshgvd|ezhiyurdjgukwixshgvd@gmail.com|ezhiyurdjgukwixshgvd
autdxizmuhtgbjcttqsa|autdxizmuhtgbjcttqsa@gmail.com|autdxizmuhtgbjcttqsa
sbwmhpkzsdxrpqshwixe|sbwmhpkzsdxrpqshwixe@gmail.com|sbwmhpkzsdxrpqshwixe
zopszmgovxxtgwwlzrxj|zopszmgovxxtgwwlzrxj@gmail.com|zopszmgovxxtgwwlzrxj
uveghthmrxtcqjibdjfc|uveghthmrxtcqjibdjfc@gmail.com|uveghthmrxtcqjibdjfc
hpuvcfeecyhjkmesbdgk|hpuvcfeecyhjkmesbdgk@gmail.com|hpuvcfeecyhjkmesbdgk
ufiostywbinnmroeyccc|ufiostywbinnmroeyccc@gmail.com|ufiostywbinnmroeyccc
emueesuglofvblwczyze|emueesuglofvblwczyze@gmail.com|emueesuglofvblwczyze
rqazjlhfortykynebmeh|rqazjlhfortykynebmeh@gmail.com|rqazjlhfortykynebmeh
mhjbyxamizayzdihnulj|mhjbyxamizayzdihnulj@gmail.com|mhjbyxamizayzdihnulj
dkmvmftxqpbwjlklcnhm|dkmvmftxqpbwjlklcnhm@gmail.com|dkmvmftxqpbwjlklcnhm
cauqiwznvzjbdbpuolwg|cauqiwznvzjbdbpuolwg@gmail.com|cauqiwznvzjbdbpuolwg
aqipaworvncbgryhwjnc|aqipaworvncbgryhwjnc@gmail.com|aqipaworvncbgryhwjnc
ozumpgpzwhzdjygppfij|ozumpgpzwhzdjygppfij@gmail.com|ozumpgpzwhzdjygppfij
bthucnzuduisrinowofx|bthucnzuduisrinowofx@gmail.com|bthucnzuduisrinowofx
ufypyrdtsakpqmjmgvlb|ufypyrdtsakpqmjmgvlb@gmail.com|ufypyrdtsakpqmjmgvlb
uzfnteayzzqmtniogodd|uzfnteayzzqmtniogodd@gmail.com|uzfnteayzzqmtniogodd
thzsxekdrrfppsyxgllb|thzsxekdrrfppsyxgllb@gmail.com|thzsxekdrrfppsyxgllb
kqxfofffoekwkbygahkf|kqxfofffoekwkbygahkf@gmail.com|kqxfofffoekwkbygahkf
wnxignpgeawccxwgkkfx|wnxignpgeawccxwgkkfx@gmail.com|wnxignpgeawccxwgkkfx
iaqglrhzjqszwrfshear|iaqglrhzjqszwrfshear@gmail.com|iaqglrhzjqszwrfshear
mmeuoadofrlgtmhfoumz|mmeuoadofrlgtmhfoumz@gmail.com|mmeuoadofrlgtmhfoumz
nrexranvwrhdiyzkocyb|nrexranvwrhdiyzkocyb@gmail.com|nrexranvwrhdiyzkocyb
vgtoceipcfdjmogxrpcl|vgtoceipcfdjmogxrpcl@gmail.com|vgtoceipcfdjmogxrpcl
oyzmgxqphdtgmfnnbgvu|oyzmgxqphdtgmfnnbgvu@gmail.com|oyzmgxqphdtgmfnnbgvu
obuqdxzwnpnbzompbfeh|obuqdxzwnpnbzompbfeh@gmail.com|obuqdxzwnpnbzompbfeh
pbmqibovadwwqjsxlpdv|pbmqibovadwwqjsxlpdv@gmail.com|pbmqibovadwwqjsxlpdv
uenigboxsewuaksixcpu|uenigboxsewuaksixcpu@gmail.com|uenigboxsewuaksixcpu
cvpliqlxkarrvjvfjoct|cvpliqlxkarrvjvfjoct@gmail.com|cvpliqlxkarrvjvfjoct
gywtqdazdxvezpnfveia|gywtqdazdxvezpnfveia@gmail.com|gywtqdazdxvezpnfveia
elqadzlxoanixlxwzaah|elqadzlxoanixlxwzaah@gmail.com|elqadzlxoanixlxwzaah
ciliouhwjqkklmiolroi|ciliouhwjqkklmiolroi@gmail.com|ciliouhwjqkklmiolroi
hiopjlsrpwyhcgwniiag|hiopjlsrpwyhcgwniiag@gmail.com|hiopjlsrpwyhcgwniiag
icaqvdrftlerrnnkjllj|icaqvdrftlerrnnkjllj@gmail.com|icaqvdrftlerrnnkjllj
zqarsvwsjxpxcvqymwni|zqarsvwsjxpxcvqymwni@gmail.com|zqarsvwsjxpxcvqymwni
wfrspbqjsgqlcuyclmvp|wfrspbqjsgqlcuyclmvp@gmail.com|wfrspbqjsgqlcuyclmvp
mnrvdrbcthispzovulak|mnrvdrbcthispzovulak@gmail.com|mnrvdrbcthispzovulak
tnzruexequerdoohjiyd|tnzruexequerdoohjiyd@gmail.com|tnzruexequerdoohjiyd
pqljflotbbtfkekptnmt|pqljflotbbtfkekptnmt@gmail.com|pqljflotbbtfkekptnmt
zyrgvxflnhabttnlfscw|zyrgvxflnhabttnlfscw@gmail.com|zyrgvxflnhabttnlfscw
dovjwkdhsxsfpnvltyty|dovjwkdhsxsfpnvltyty@gmail.com|dovjwkdhsxsfpnvltyty
fgwjfsivymhfyogyhvix|fgwjfsivymhfyogyhvix@gmail.com|fgwjfsivymhfyogyhvix
vcwzkhbxiscxczuyrgzk|vcwzkhbxiscxczuyrgzk@gmail.com|vcwzkhbxiscxczuyrgzk
ddawchydnfurabwsgqie|ddawchydnfurabwsgqie@gmail.com|ddawchydnfurabwsgqie
hbfzytsbjlpqvezbkraz|hbfzytsbjlpqvezbkraz@gmail.com|hbfzytsbjlpqvezbkraz
zposgmykybnsizowdjqp|zposgmykybnsizowdjqp@gmail.com|zposgmykybnsizowdjqp
lhigujoihwrakymifpjd|lhigujoihwrakymifpjd@gmail.com|lhigujoihwrakymifpjd
gifswpmikrtwagkjgdad|gifswpmikrtwagkjgdad@gmail.com|gifswpmikrtwagkjgdad
toumwipgsuxavcxazjbe|toumwipgsuxavcxazjbe@gmail.com|toumwipgsuxavcxazjbe
mxezvfljipucgsfbmlcp|mxezvfljipucgsfbmlcp@gmail.com|mxezvfljipucgsfbmlcp
ppimzsojjfgecmpesika|ppimzsojjfgecmpesika@gmail.com|ppimzsojjfgecmpesika
ouvoqjzrbdvcdexbkqhu|ouvoqjzrbdvcdexbkqhu@gmail.com|ouvoqjzrbdvcdexbkqhu
usexjyxyahfpjrzsqazc|usexjyxyahfpjrzsqazc@gmail.com|usexjyxyahfpjrzsqazc
jfpxvclebxypqjbimlou|jfpxvclebxypqjbimlou@gmail.com|jfpxvclebxypqjbimlou
gomazlhzidmzkdoqtdmg|gomazlhzidmzkdoqtdmg@gmail.com|gomazlhzidmzkdoqtdmg
obnkfllddvkynobemrbl|obnkfllddvkynobemrbl@gmail.com|obnkfllddvkynobemrbl
hbrrvbjuhmopxhvmpeky|hbrrvbjuhmopxhvmpeky@gmail.com|hbrrvbjuhmopxhvmpeky
bidfhuoyjtyswpucpjcf|bidfhuoyjtyswpucpjcf@gmail.com|bidfhuoyjtyswpucpjcf
kamglccqsrcauvobnash|kamglccqsrcauvobnash@gmail.com|kamglccqsrcauvobnash
ctskinkgbugalvsgqtva|ctskinkgbugalvsgqtva@gmail.com|ctskinkgbugalvsgqtva
qalsvyuqeonyzdlgzckr|qalsvyuqeonyzdlgzckr@gmail.com|qalsvyuqeonyzdlgzckr
bnpyodkcwqdlqnybvuyf|bnpyodkcwqdlqnybvuyf@gmail.com|bnpyodkcwqdlqnybvuyf
mnyqeiuxujtmfbbmtdol|mnyqeiuxujtmfbbmtdol@gmail.com|mnyqeiuxujtmfbbmtdol
mjjykvfrmrzecexgsibc|mjjykvfrmrzecexgsibc@gmail.com|mjjykvfrmrzecexgsibc
rsposrtygirkiwtofegm|rsposrtygirkiwtofegm@gmail.com|rsposrtygirkiwtofegm
edmbfmygmkqgimiglmin|edmbfmygmkqgimiglmin@gmail.com|edmbfmygmkqgimiglmin
gnxcbsldbdknoygsbfgr|gnxcbsldbdknoygsbfgr@gmail.com|gnxcbsldbdknoygsbfgr
byzawwrcszhkbvcrjije|byzawwrcszhkbvcrjije@gmail.com|byzawwrcszhkbvcrjije
czsofvzprwqwrapexexv|czsofvzprwqwrapexexv@gmail.com|czsofvzprwqwrapexexv
scxznygbsucdpglyzkfj|scxznygbsucdpglyzkfj@gmail.com|scxznygbsucdpglyzkfj
luxxorqqojmadinaqutn|luxxorqqojmadinaqutn@gmail.com|luxxorqqojmadinaqutn
fvvzawjuwhiswolihhvv|fvvzawjuwhiswolihhvv@gmail.com|fvvzawjuwhiswolihhvv
pflqomeapuccqfnejlbi|pflqomeapuccqfnejlbi@gmail.com|pflqomeapuccqfnejlbi
blxkkaulizvysxssrgvd|blxkkaulizvysxssrgvd@gmail.com|blxkkaulizvysxssrgvd
gtjmmmkpuiomsjfptqxc|gtjmmmkpuiomsjfptqxc@gmail.com|gtjmmmkpuiomsjfptqxc
tduzhfzdoobbgexlogkc|tduzhfzdoobbgexlogkc@gmail.com|tduzhfzdoobbgexlogkc
csyapmcdnvfpgrgmjdzy|csyapmcdnvfpgrgmjdzy@gmail.com|csyapmcdnvfpgrgmjdzy
kfweanzbtagaapdnctlo|kfweanzbtagaapdnctlo@gmail.com|kfweanzbtagaapdnctlo
jfueteulgdwlpckwycsr|jfueteulgdwlpckwycsr@gmail.com|jfueteulgdwlpckwycsr
zfkwgmmqgjhoahsmaxey|zfkwgmmqgjhoahsmaxey@gmail.com|zfkwgmmqgjhoahsmaxey
tkebmknmqbmviqeafjhy|tkebmknmqbmviqeafjhy@gmail.com|tkebmknmqbmviqeafjhy
syvyxulqtbejgoblvxfh|syvyxulqtbejgoblvxfh@gmail.com|syvyxulqtbejgoblvxfh
purroaedhidcyexgnxkb|purroaedhidcyexgnxkb@gmail.com|purroaedhidcyexgnxkb
ftoyocgmtpxfgwlrwuxg|ftoyocgmtpxfgwlrwuxg@gmail.com|ftoyocgmtpxfgwlrwuxg
ainrnpjnmnsslbwuinwc|ainrnpjnmnsslbwuinwc@gmail.com|ainrnpjnmnsslbwuinwc
azapoodvcgaytgxfpect|azapoodvcgaytgxfpect@gmail.com|azapoodvcgaytgxfpect
kgwhgjvdnbvyetiqmtrv|kgwhgjvdnbvyetiqmtrv@gmail.com|kgwhgjvdnbvyetiqmtrv
lpkgkzapzbykkktxaeyd|lpkgkzapzbykkktxaeyd@gmail.com|lpkgkzapzbykkktxaeyd
qemhsfbbkuekjflvsqex|qemhsfbbkuekjflvsqex@gmail.com|qemhsfbbkuekjflvsqex
syyacqgzasmgohxccryj|syyacqgzasmgohxccryj@gmail.com|syyacqgzasmgohxccryj
asarhmwlkllfnnkiiygy|asarhmwlkllfnnkiiygy@gmail.com|asarhmwlkllfnnkiiygy
injugkjmevzmitgisgsh|injugkjmevzmitgisgsh@gmail.com|injugkjmevzmitgisgsh
diiqjdfpelfmlyklfzqc|diiqjdfpelfmlyklfzqc@gmail.com|diiqjdfpelfmlyklfzqc
csnlcmnkonfoednhpgsj|csnlcmnkonfoednhpgsj@gmail.com|csnlcmnkonfoednhpgsj
eqmeoxldtlvrymambpgn|eqmeoxldtlvrymambpgn@gmail.com|eqmeoxldtlvrymambpgn
aiyqafptegenghtnqeeh|aiyqafptegenghtnqeeh@gmail.com|aiyqafptegenghtnqeeh
zuwuyawpuzbasgaixjjb|zuwuyawpuzbasgaixjjb@gmail.com|zuwuyawpuzbasgaixjjb
debuownnfwhstklpzytf|debuownnfwhstklpzytf@gmail.com|debuownnfwhstklpzytf
onrykarobnfervyweqjv|onrykarobnfervyweqjv@gmail.com|onrykarobnfervyweqjv
vlkxhlcphmbfnlqhtrhk|vlkxhlcphmbfnlqhtrhk@gmail.com|vlkxhlcphmbfnlqhtrhk
cvhnimqvafexoqhnykqb|cvhnimqvafexoqhnykqb@gmail.com|cvhnimqvafexoqhnykqb
fafxeknqvsspykfgdfky|fafxeknqvsspykfgdfky@gmail.com|fafxeknqvsspykfgdfky
ryqerqamflhqidmbtmll|ryqerqamflhqidmbtmll@gmail.com|ryqerqamflhqidmbtmll
gujotwvqqdwerrukxrng|gujotwvqqdwerrukxrng@gmail.com|gujotwvqqdwerrukxrng
tlgtujupqokdgrmoduco|tlgtujupqokdgrmoduco@gmail.com|tlgtujupqokdgrmoduco
idedzhjabbaevuluasoa|idedzhjabbaevuluasoa@gmail.com|idedzhjabbaevuluasoa
zfllihqplszyqyumwpgl|zfllihqplszyqyumwpgl@gmail.com|zfllihqplszyqyumwpgl
kzuglgkcyfueakjglefn|kzuglgkcyfueakjglefn@gmail.com|kzuglgkcyfueakjglefn
mfxezmtqbypryivwsrse|mfxezmtqbypryivwsrse@gmail.com|mfxezmtqbypryivwsrse
ccuzuzvmpucptfvsqjaf|ccuzuzvmpucptfvsqjaf@gmail.com|ccuzuzvmpucptfvsqjaf
usufrknabhsxxsfpdryc|usufrknabhsxxsfpdryc@gmail.com|usufrknabhsxxsfpdryc
ojwyuffhkgtgdpphcwbr|ojwyuffhkgtgdpphcwbr@gmail.com|ojwyuffhkgtgdpphcwbr
bmpvkurklyozsbanplfa|bmpvkurklyozsbanplfa@gmail.com|bmpvkurklyozsbanplfa
ejiynclgtfyldqflprkl|ejiynclgtfyldqflprkl@gmail.com|ejiynclgtfyldqflprkl
mvynvpyuaqnmpsrxfrdb|mvynvpyuaqnmpsrxfrdb@gmail.com|mvynvpyuaqnmpsrxfrdb
cunnapecvdcujfgmzspb|cunnapecvdcujfgmzspb@gmail.com|cunnapecvdcujfgmzspb
tntxklnyvpdhmwheadhz|tntxklnyvpdhmwheadhz@gmail.com|tntxklnyvpdhmwheadhz
iweprmxzamvudfrbzzlr|iweprmxzamvudfrbzzlr@gmail.com|iweprmxzamvudfrbzzlr
jdvrltezkxzrwqwlpxkc|jdvrltezkxzrwqwlpxkc@gmail.com|jdvrltezkxzrwqwlpxkc
cpsxpfamiyhsltcvlehg|cpsxpfamiyhsltcvlehg@gmail.com|cpsxpfamiyhsltcvlehg
ecvvdschxiodjhqiygzq|ecvvdschxiodjhqiygzq@gmail.com|ecvvdschxiodjhqiygzq
dhiujknrlikspzwvansi|dhiujknrlikspzwvansi@gmail.com|dhiujknrlikspzwvansi
igcactqwcccexgolcroq|igcactqwcccexgolcroq@gmail.com|igcactqwcccexgolcroq
rcwyebbwkdgruckfhjrh|rcwyebbwkdgruckfhjrh@gmail.com|rcwyebbwkdgruckfhjrh
totoyycrhrldzwvimivs|totoyycrhrldzwvimivs@gmail.com|totoyycrhrldzwvimivs
yvdvngfiapxhxruwldpd|yvdvngfiapxhxruwldpd@gmail.com|yvdvngfiapxhxruwldpd
sqdxtqtybxwudhhwxzyo|sqdxtqtybxwudhhwxzyo@gmail.com|sqdxtqtybxwudhhwxzyo
zdxdandbgvpiacbrglpp|zdxdandbgvpiacbrglpp@gmail.com|zdxdandbgvpiacbrglpp
wwlonamvgqyomghhqfub|wwlonamvgqyomghhqfub@gmail.com|wwlonamvgqyomghhqfub
baukfafasmzbalvfvery|baukfafasmzbalvfvery@gmail.com|baukfafasmzbalvfvery
rvbztopzixkhyedvssjx|rvbztopzixkhyedvssjx@gmail.com|rvbztopzixkhyedvssjx
iabuebhgytkqfewlorcr|iabuebhgytkqfewlorcr@gmail.com|iabuebhgytkqfewlorcr
sqpkldqwirenbgzjhotg|sqpkldqwirenbgzjhotg@gmail.com|sqpkldqwirenbgzjhotg
nqcitlcmkqscjzxgkiij|nqcitlcmkqscjzxgkiij@gmail.com|nqcitlcmkqscjzxgkiij
durmgoztebdtyggrseet|durmgoztebdtyggrseet@gmail.com|durmgoztebdtyggrseet
ltpbnvlmxkpxrrhcwvcm|ltpbnvlmxkpxrrhcwvcm@gmail.com|ltpbnvlmxkpxrrhcwvcm
pxfmpwpybvzwraklffyw|pxfmpwpybvzwraklffyw@gmail.com|pxfmpwpybvzwraklffyw
lqhlrunamznovxnasvwt|lqhlrunamznovxnasvwt@gmail.com|lqhlrunamznovxnasvwt
jdyzfclpqcqjjmvdoeyz|jdyzfclpqcqjjmvdoeyz@gmail.com|jdyzfclpqcqjjmvdoeyz
fosqoelsmdpxbrdcqyvl|fosqoelsmdpxbrdcqyvl@gmail.com|fosqoelsmdpxbrdcqyvl
pyvsouyhaptggqzubggo|pyvsouyhaptggqzubggo@gmail.com|pyvsouyhaptggqzubggo
gfmlqpcefbcrrlchghzi|gfmlqpcefbcrrlchghzi@gmail.com|gfmlqpcefbcrrlchghzi
xmitogsaxvkajjaaskez|xmitogsaxvkajjaaskez@gmail.com|xmitogsaxvkajjaaskez
qjjyzuxakxdpmlrsarpx|qjjyzuxakxdpmlrsarpx@gmail.com|qjjyzuxakxdpmlrsarpx
zjolyvfhkqwugjjpuumm|zjolyvfhkqwugjjpuumm@gmail.com|zjolyvfhkqwugjjpuumm
wdggrffoyvkzsjkxjjcl|wdggrffoyvkzsjkxjjcl@gmail.com|wdggrffoyvkzsjkxjjcl
ggogynrtlvjsnhwqxzsq|ggogynrtlvjsnhwqxzsq@gmail.com|ggogynrtlvjsnhwqxzsq
padqvoscwrzoimbiidwp|padqvoscwrzoimbiidwp@gmail.com|padqvoscwrzoimbiidwp
zkzljkuqbtkuugkoqcai|zkzljkuqbtkuugkoqcai@gmail.com|zkzljkuqbtkuugkoqcai
rbuerhguwsxcfzhxuvfd|rbuerhguwsxcfzhxuvfd@gmail.com|rbuerhguwsxcfzhxuvfd
ucfrdoahoepdxnjgcpbj|ucfrdoahoepdxnjgcpbj@gmail.com|ucfrdoahoepdxnjgcpbj
adnsxbnfbhvadysxylxn|adnsxbnfbhvadysxylxn@gmail.com|adnsxbnfbhvadysxylxn
xjmzxjkvbvdgudieydmz|xjmzxjkvbvdgudieydmz@gmail.com|xjmzxjkvbvdgudieydmz
rxyoysvhcsthcdctypym|rxyoysvhcsthcdctypym@gmail.com|rxyoysvhcsthcdctypym
jlpmxnfcctziptiimdqc|jlpmxnfcctziptiimdqc@gmail.com|jlpmxnfcctziptiimdqc
ldajfrgtpvgezmdehvvc|ldajfrgtpvgezmdehvvc@gmail.com|ldajfrgtpvgezmdehvvc
akttrwgijaevxcoakchv|akttrwgijaevxcoakchv@gmail.com|akttrwgijaevxcoakchv
irlxzoroidglctixwzeq|irlxzoroidglctixwzeq@gmail.com|irlxzoroidglctixwzeq
qumyfumvojenpooymoig|qumyfumvojenpooymoig@gmail.com|qumyfumvojenpooymoig
ymipjesnhmghupwnmvcz|ymipjesnhmghupwnmvcz@gmail.com|ymipjesnhmghupwnmvcz
vparwgmvmziqlmvndpsd|vparwgmvmziqlmvndpsd@gmail.com|vparwgmvmziqlmvndpsd
elwubupwqpixnhbjxwld|elwubupwqpixnhbjxwld@gmail.com|elwubupwqpixnhbjxwld
zbwlvctqofzypxskxkxv|zbwlvctqofzypxskxkxv@gmail.com|zbwlvctqofzypxskxkxv
dtubrysymqskpiizuzqz|dtubrysymqskpiizuzqz@gmail.com|dtubrysymqskpiizuzqz
yqrgvcgunejksjtkutna|yqrgvcgunejksjtkutna@gmail.com|yqrgvcgunejksjtkutna
ltjiatrmasxltcbtqhkg|ltjiatrmasxltcbtqhkg@gmail.com|ltjiatrmasxltcbtqhkg
nounwtolohkmhhzryntg|nounwtolohkmhhzryntg@gmail.com|nounwtolohkmhhzryntg
dimymepvbdymujyiupeq|dimymepvbdymujyiupeq@gmail.com|dimymepvbdymujyiupeq
cauodzthimugcdycnatp|cauodzthimugcdycnatp@gmail.com|cauodzthimugcdycnatp
biwzcooxyhfolodnnwhj|biwzcooxyhfolodnnwhj@gmail.com|biwzcooxyhfolodnnwhj
bjmoygtifheahtubhtpa|bjmoygtifheahtubhtpa@gmail.com|bjmoygtifheahtubhtpa
mxrpacixbvtzicfzozxo|mxrpacixbvtzicfzozxo@gmail.com|mxrpacixbvtzicfzozxo
tvtnldvckaarewilfesr|tvtnldvckaarewilfesr@gmail.com|tvtnldvckaarewilfesr
beqesksvxnleeudyacch|beqesksvxnleeudyacch@gmail.com|beqesksvxnleeudyacch
jkiixohxfhpqyjzhhgrg|jkiixohxfhpqyjzhhgrg@gmail.com|jkiixohxfhpqyjzhhgrg
amqwnzswfimiewkiklnm|amqwnzswfimiewkiklnm@gmail.com|amqwnzswfimiewkiklnm
msrqguwokuhdrkxwkwmj|msrqguwokuhdrkxwkwmj@gmail.com|msrqguwokuhdrkxwkwmj
gtomesptypacswugdehz|gtomesptypacswugdehz@gmail.com|gtomesptypacswugdehz
bddrtovcvqlqucgbqord|bddrtovcvqlqucgbqord@gmail.com|bddrtovcvqlqucgbqord
swmqerdomggrywmdcwnz|swmqerdomggrywmdcwnz@gmail.com|swmqerdomggrywmdcwnz
hbwuzzrneqfuascmmknt|hbwuzzrneqfuascmmknt@gmail.com|hbwuzzrneqfuascmmknt
gvjdbrzwdizgthmglyor|gvjdbrzwdizgthmglyor@gmail.com|gvjdbrzwdizgthmglyor
igympptcfrslasplqmov|igympptcfrslasplqmov@gmail.com|igympptcfrslasplqmov
arpmxfhoeyndjszmnxbl|arpmxfhoeyndjszmnxbl@gmail.com|arpmxfhoeyndjszmnxbl
jmcndynqvtaavscxqmyk|jmcndynqvtaavscxqmyk@gmail.com|jmcndynqvtaavscxqmyk
acruouwvwzfsecpufoun|acruouwvwzfsecpufoun@gmail.com|acruouwvwzfsecpufoun
chbhtkxklmneorphozug|chbhtkxklmneorphozug@gmail.com|chbhtkxklmneorphozug
dcvxjcrdolwhnwnangtg|dcvxjcrdolwhnwnangtg@gmail.com|dcvxjcrdolwhnwnangtg
mcqevyvejfwsgbthufae|mcqevyvejfwsgbthufae@gmail.com|mcqevyvejfwsgbthufae
oztwqadfyetqfkwueisc|oztwqadfyetqfkwueisc@gmail.com|oztwqadfyetqfkwueisc
zoqvzkykyvbjtnkbwlvq|zoqvzkykyvbjtnkbwlvq@gmail.com|zoqvzkykyvbjtnkbwlvq
ywqupenljdsdggqyapli|ywqupenljdsdggqyapli@gmail.com|ywqupenljdsdggqyapli
jqikwwquujkawoefkhgc|jqikwwquujkawoefkhgc@gmail.com|jqikwwquujkawoefkhgc
ifjgyxolklkfjslphrev|ifjgyxolklkfjslphrev@gmail.com|ifjgyxolklkfjslphrev
yguwwfamhprhzscecrbq|yguwwfamhprhzscecrbq@gmail.com|yguwwfamhprhzscecrbq
hglweskireelnpigwsdu|hglweskireelnpigwsdu@gmail.com|hglweskireelnpigwsdu
yynbcyuohasehsdljodc|yynbcyuohasehsdljodc@gmail.com|yynbcyuohasehsdljodc
hpagwcgqgxgdvcurltvt|hpagwcgqgxgdvcurltvt@gmail.com|hpagwcgqgxgdvcurltvt
lwfobrtdoaliygaevals|lwfobrtdoaliygaevals@gmail.com|lwfobrtdoaliygaevals
qekpwlkdmotaszcxcifq|qekpwlkdmotaszcxcifq@gmail.com|qekpwlkdmotaszcxcifq
yyvhselpuqxupqawbxot|yyvhselpuqxupqawbxot@gmail.com|yyvhselpuqxupqawbxot
dioytucmlbgqscztxbns|dioytucmlbgqscztxbns@gmail.com|dioytucmlbgqscztxbns
pfvrdycngmrcfxcsumuc|pfvrdycngmrcfxcsumuc@gmail.com|pfvrdycngmrcfxcsumuc
eesllcehliphwgphwzke|eesllcehliphwgphwzke@gmail.com|eesllcehliphwgphwzke
cfolhpcpwpjbxzgjcirf|cfolhpcpwpjbxzgjcirf@gmail.com|cfolhpcpwpjbxzgjcirf
yqihjggcvolifktpiocr|yqihjggcvolifktpiocr@gmail.com|yqihjggcvolifktpiocr
xapyufqduwtfgbdrzhcw|xapyufqduwtfgbdrzhcw@gmail.com|xapyufqduwtfgbdrzhcw
yfkmmcmbegtzvudvrrkf|yfkmmcmbegtzvudvrrkf@gmail.com|yfkmmcmbegtzvudvrrkf
hzxtllhcdrgcswecahja|hzxtllhcdrgcswecahja@gmail.com|hzxtllhcdrgcswecahja
otyipmssnvzljxpgulml|otyipmssnvzljxpgulml@gmail.com|otyipmssnvzljxpgulml
mbepdjcvwawtleyuvwig|mbepdjcvwawtleyuvwig@gmail.com|mbepdjcvwawtleyuvwig
cvthvscukclcjevyetnv|cvthvscukclcjevyetnv@gmail.com|cvthvscukclcjevyetnv
eifbvqhfpnzhfhuvlttc|eifbvqhfpnzhfhuvlttc@gmail.com|eifbvqhfpnzhfhuvlttc
kyaxkbmuycpvajmqkvgx|kyaxkbmuycpvajmqkvgx@gmail.com|kyaxkbmuycpvajmqkvgx
zwtfxnmpobsucvvwaedh|zwtfxnmpobsucvvwaedh@gmail.com|zwtfxnmpobsucvvwaedh
volhtsyjdeiqlhggpoao|volhtsyjdeiqlhggpoao@gmail.com|volhtsyjdeiqlhggpoao
jlejmitsnipuqqqojxbb|jlejmitsnipuqqqojxbb@gmail.com|jlejmitsnipuqqqojxbb
sfykfwhqzhothxasihia|sfykfwhqzhothxasihia@gmail.com|sfykfwhqzhothxasihia
jfefzqpjucjlismxszzg|jfefzqpjucjlismxszzg@gmail.com|jfefzqpjucjlismxszzg
ncnwlorfmdhywbmfdzwz|ncnwlorfmdhywbmfdzwz@gmail.com|ncnwlorfmdhywbmfdzwz
cmdlreltbwhrcbpjscwc|cmdlreltbwhrcbpjscwc@gmail.com|cmdlreltbwhrcbpjscwc
zeqslivjznkeyhzxluef|zeqslivjznkeyhzxluef@gmail.com|zeqslivjznkeyhzxluef
gobhwfphbgmgrymmskaj|gobhwfphbgmgrymmskaj@gmail.com|gobhwfphbgmgrymmskaj
abemdhjhwzhujanadbsi|abemdhjhwzhujanadbsi@gmail.com|abemdhjhwzhujanadbsi
fpzfbgoimvyshgbpxxbj|fpzfbgoimvyshgbpxxbj@gmail.com|fpzfbgoimvyshgbpxxbj
uuqnrjwrhqyqrbiuyunq|uuqnrjwrhqyqrbiuyunq@gmail.com|uuqnrjwrhqyqrbiuyunq
bakroxqcciercqimvbek|bakroxqcciercqimvbek@gmail.com|bakroxqcciercqimvbek
cvhjmyxqdyjblhtlwbye|cvhjmyxqdyjblhtlwbye@gmail.com|cvhjmyxqdyjblhtlwbye
gvynkapbbmnhvjkozzxt|gvynkapbbmnhvjkozzxt@gmail.com|gvynkapbbmnhvjkozzxt
rwqkrclqyakvsubswikg|rwqkrclqyakvsubswikg@gmail.com|rwqkrclqyakvsubswikg
ymcluxirneshqsvjcydm|ymcluxirneshqsvjcydm@gmail.com|ymcluxirneshqsvjcydm
ezesmmuzeflfulumktdr|ezesmmuzeflfulumktdr@gmail.com|ezesmmuzeflfulumktdr
ltpsvvhijlbjyjufojbf|ltpsvvhijlbjyjufojbf@gmail.com|ltpsvvhijlbjyjufojbf
ojmwoqkyltbgpcongtdd|ojmwoqkyltbgpcongtdd@gmail.com|ojmwoqkyltbgpcongtdd
piibaipkpgqrnzmldtom|piibaipkpgqrnzmldtom@gmail.com|piibaipkpgqrnzmldtom
lleijhosovhnxeznbags|lleijhosovhnxeznbags@gmail.com|lleijhosovhnxeznbags
vifukkuaurpwiemdzllj|vifukkuaurpwiemdzllj@gmail.com|vifukkuaurpwiemdzllj
tbclfbxvdlrkcvuejfpb|tbclfbxvdlrkcvuejfpb@gmail.com|tbclfbxvdlrkcvuejfpb
ymhwwezkxucvtwpevhmp|ymhwwezkxucvtwpevhmp@gmail.com|ymhwwezkxucvtwpevhmp
lwotafmtagjqczconlep|lwotafmtagjqczconlep@gmail.com|lwotafmtagjqczconlep
ugziiakmbccvssbbcpog|ugziiakmbccvssbbcpog@gmail.com|ugziiakmbccvssbbcpog
jtxrfweuluclpqlxgfpu|jtxrfweuluclpqlxgfpu@gmail.com|jtxrfweuluclpqlxgfpu
nidxskbibtzicavnvlyj|nidxskbibtzicavnvlyj@gmail.com|nidxskbibtzicavnvlyj
uxuvzxswcrrgnhicarqk|uxuvzxswcrrgnhicarqk@gmail.com|uxuvzxswcrrgnhicarqk
zkdvfrxcbcioiwxluwwu|zkdvfrxcbcioiwxluwwu@gmail.com|zkdvfrxcbcioiwxluwwu
nddvvnumgewtkqzgumus|nddvvnumgewtkqzgumus@gmail.com|nddvvnumgewtkqzgumus
mcrkaptewcygvczppucm|mcrkaptewcygvczppucm@gmail.com|mcrkaptewcygvczppucm
bcplviqdmleykepjxgvb|bcplviqdmleykepjxgvb@gmail.com|bcplviqdmleykepjxgvb
jvgvoblhlbpevndwbfgh|jvgvoblhlbpevndwbfgh@gmail.com|jvgvoblhlbpevndwbfgh
mlcrgrgwmfnsdhkmbxkl|mlcrgrgwmfnsdhkmbxkl@gmail.com|mlcrgrgwmfnsdhkmbxkl
rirkbutmokurcxjhqauo|rirkbutmokurcxjhqauo@gmail.com|rirkbutmokurcxjhqauo
tkcadytcgqagjvubbdni|tkcadytcgqagjvubbdni@gmail.com|tkcadytcgqagjvubbdni
hsozcbotynrayzdhvxhb|hsozcbotynrayzdhvxhb@gmail.com|hsozcbotynrayzdhvxhb
tfndwsnvxeivqapvhvzz|tfndwsnvxeivqapvhvzz@gmail.com|tfndwsnvxeivqapvhvzz
nhzmpmllospwhmvirsfb|nhzmpmllospwhmvirsfb@gmail.com|nhzmpmllospwhmvirsfb
mkmulghfsxjhqnpncaqy|mkmulghfsxjhqnpncaqy@gmail.com|mkmulghfsxjhqnpncaqy
clokxlpufxxvwhftvzgk|clokxlpufxxvwhftvzgk@gmail.com|clokxlpufxxvwhftvzgk
njmpncnwpsgkxewidrvf|njmpncnwpsgkxewidrvf@gmail.com|njmpncnwpsgkxewidrvf
reqexmoqkfxjrumqxljp|reqexmoqkfxjrumqxljp@gmail.com|reqexmoqkfxjrumqxljp
oindykunzeharvmbxhdu|oindykunzeharvmbxhdu@gmail.com|oindykunzeharvmbxhdu
axkwjlbbvjutijnkqsnx|axkwjlbbvjutijnkqsnx@gmail.com|axkwjlbbvjutijnkqsnx
zlludhbenpsbccjjanxj|zlludhbenpsbccjjanxj@gmail.com|zlludhbenpsbccjjanxj
wtrbamkudibrdfkmdqns|wtrbamkudibrdfkmdqns@gmail.com|wtrbamkudibrdfkmdqns
jeiwjyikrhkivfvtthxq|jeiwjyikrhkivfvtthxq@gmail.com|jeiwjyikrhkivfvtthxq
bfgjzkbelslnypdoiyoc|bfgjzkbelslnypdoiyoc@gmail.com|bfgjzkbelslnypdoiyoc
gnnoaaushfvyadytjfjr|gnnoaaushfvyadytjfjr@gmail.com|gnnoaaushfvyadytjfjr
ucdxsgyoqkqtfiobsmnf|ucdxsgyoqkqtfiobsmnf@gmail.com|ucdxsgyoqkqtfiobsmnf
tkxmkdufjmzkhjrqhxpl|tkxmkdufjmzkhjrqhxpl@gmail.com|tkxmkdufjmzkhjrqhxpl
qkbgvwozbtqpwamlrhbn|qkbgvwozbtqpwamlrhbn@gmail.com|qkbgvwozbtqpwamlrhbn
fulhfugtotfvigfocten|fulhfugtotfvigfocten@gmail.com|fulhfugtotfvigfocten
yiwxivnwnpnyltjhgtxf|yiwxivnwnpnyltjhgtxf@gmail.com|yiwxivnwnpnyltjhgtxf
zsnvxlmeisbgzxisrrhr|zsnvxlmeisbgzxisrrhr@gmail.com|zsnvxlmeisbgzxisrrhr
jxtxcdomqegtcidajvbx|jxtxcdomqegtcidajvbx@gmail.com|jxtxcdomqegtcidajvbx
hpylqcznpzcxjfdqcrai|hpylqcznpzcxjfdqcrai@gmail.com|hpylqcznpzcxjfdqcrai
drtxbozvjkpjuznllbcf|drtxbozvjkpjuznllbcf@gmail.com|drtxbozvjkpjuznllbcf
kaxreawtbecbfywogmwt|kaxreawtbecbfywogmwt@gmail.com|kaxreawtbecbfywogmwt
yrnhhdurgbxwokcgpjuu|yrnhhdurgbxwokcgpjuu@gmail.com|yrnhhdurgbxwokcgpjuu
pmjjegfolodgtphzxwst|pmjjegfolodgtphzxwst@gmail.com|pmjjegfolodgtphzxwst
zqzyjsnpqbmrspqteeyj|zqzyjsnpqbmrspqteeyj@gmail.com|zqzyjsnpqbmrspqteeyj
gvncvvvdhgoinhqkyeqe|gvncvvvdhgoinhqkyeqe@gmail.com|gvncvvvdhgoinhqkyeqe
aszudvlpxrzcphdxotin|aszudvlpxrzcphdxotin@gmail.com|aszudvlpxrzcphdxotin
nkanxiwlaahwnbzlifhf|nkanxiwlaahwnbzlifhf@gmail.com|nkanxiwlaahwnbzlifhf
onueodzmejoutpwpqotr|onueodzmejoutpwpqotr@gmail.com|onueodzmejoutpwpqotr
meyjgnlfelajpqxgkldu|meyjgnlfelajpqxgkldu@gmail.com|meyjgnlfelajpqxgkldu
dueabvbysmgjkhhdvkbl|dueabvbysmgjkhhdvkbl@gmail.com|dueabvbysmgjkhhdvkbl
cntshtyenhqfkfzftzzw|cntshtyenhqfkfzftzzw@gmail.com|cntshtyenhqfkfzftzzw
lpkkdsevurxyfqwnslod|lpkkdsevurxyfqwnslod@gmail.com|lpkkdsevurxyfqwnslod
gsesadhvgyndnyaqzybn|gsesadhvgyndnyaqzybn@gmail.com|gsesadhvgyndnyaqzybn
xoovofvaczjmydqucddr|xoovofvaczjmydqucddr@gmail.com|xoovofvaczjmydqucddr
zdnvjbpyomdzmiccejxj|zdnvjbpyomdzmiccejxj@gmail.com|zdnvjbpyomdzmiccejxj
azvfhypgjmqwfbkfmxke|azvfhypgjmqwfbkfmxke@gmail.com|azvfhypgjmqwfbkfmxke
zfvusckwzitwysvbkmhj|zfvusckwzitwysvbkmhj@gmail.com|zfvusckwzitwysvbkmhj
idzpdrkqghsbuubjvtzu|idzpdrkqghsbuubjvtzu@gmail.com|idzpdrkqghsbuubjvtzu
qqopuhtutgxbmydbkzah|qqopuhtutgxbmydbkzah@gmail.com|qqopuhtutgxbmydbkzah
uwkbmoeooblugvazklfr|uwkbmoeooblugvazklfr@gmail.com|uwkbmoeooblugvazklfr
lvavxoxxiqrybzizkkin|lvavxoxxiqrybzizkkin@gmail.com|lvavxoxxiqrybzizkkin
ijazaemhkbhmqapqbmta|ijazaemhkbhmqapqbmta@gmail.com|ijazaemhkbhmqapqbmta
axvkxpoxsbjerwhmghzv|axvkxpoxsbjerwhmghzv@gmail.com|axvkxpoxsbjerwhmghzv
bhyaybtmdqzsuoxegnsl|bhyaybtmdqzsuoxegnsl@gmail.com|bhyaybtmdqzsuoxegnsl
cmkmuteewiosnrasbkgz|cmkmuteewiosnrasbkgz@gmail.com|cmkmuteewiosnrasbkgz
mugqejiysxzvhpzcyuxh|mugqejiysxzvhpzcyuxh@gmail.com|mugqejiysxzvhpzcyuxh
wgpcwbhtaewfurrhexdj|wgpcwbhtaewfurrhexdj@gmail.com|wgpcwbhtaewfurrhexdj
enusxrbnxyhfgezwjpjq|enusxrbnxyhfgezwjpjq@gmail.com|enusxrbnxyhfgezwjpjq
zkyolqgmqiedjmuntnfk|zkyolqgmqiedjmuntnfk@gmail.com|zkyolqgmqiedjmuntnfk
khkxvcyyezbvzufegijk|khkxvcyyezbvzufegijk@gmail.com|khkxvcyyezbvzufegijk
rpjjhhfifmokdvslbwjv|rpjjhhfifmokdvslbwjv@gmail.com|rpjjhhfifmokdvslbwjv
rreulvdibyxxpqhfxkko|rreulvdibyxxpqhfxkko@gmail.com|rreulvdibyxxpqhfxkko
hmirnsjquyasakrnuezp|hmirnsjquyasakrnuezp@gmail.com|hmirnsjquyasakrnuezp
bifmnookydqaqsczqwcm|bifmnookydqaqsczqwcm@gmail.com|bifmnookydqaqsczqwcm
etnfjcxitzvkyorlvszs|etnfjcxitzvkyorlvszs@gmail.com|etnfjcxitzvkyorlvszs
mjmltosyfpbconvmgten|mjmltosyfpbconvmgten@gmail.com|mjmltosyfpbconvmgten
mblwyenfmdicxbyyxmfz|mblwyenfmdicxbyyxmfz@gmail.com|mblwyenfmdicxbyyxmfz
asmdlchdhywpsauvlvzi|asmdlchdhywpsauvlvzi@gmail.com|asmdlchdhywpsauvlvzi
yvrrmtmejmsukvcmqmno|yvrrmtmejmsukvcmqmno@gmail.com|yvrrmtmejmsukvcmqmno
ronraziulalkyquwkjfq|ronraziulalkyquwkjfq@gmail.com|ronraziulalkyquwkjfq
vdzngucpdntjwvssodky|vdzngucpdntjwvssodky@gmail.com|vdzngucpdntjwvssodky
lmferlcyorlkkwnubjbi|lmferlcyorlkkwnubjbi@gmail.com|lmferlcyorlkkwnubjbi
lcvwhsbolxrrseuvvbao|lcvwhsbolxrrseuvvbao@gmail.com|lcvwhsbolxrrseuvvbao
izkceafyfdcnecemddpv|izkceafyfdcnecemddpv@gmail.com|izkceafyfdcnecemddpv
wbuierujhzviqychjzws|wbuierujhzviqychjzws@gmail.com|wbuierujhzviqychjzws
zhdxzujbneikztfjrezf|zhdxzujbneikztfjrezf@gmail.com|zhdxzujbneikztfjrezf
vdoawtilcvyxrboqfvkt|vdoawtilcvyxrboqfvkt@gmail.com|vdoawtilcvyxrboqfvkt
zkqtuxqhyukpqabdvyog|zkqtuxqhyukpqabdvyog@gmail.com|zkqtuxqhyukpqabdvyog
vcmpliyjfbzonlzmxheq|vcmpliyjfbzonlzmxheq@gmail.com|vcmpliyjfbzonlzmxheq
tcevgchbtyitckydqfxz|tcevgchbtyitckydqfxz@gmail.com|tcevgchbtyitckydqfxz
qjkqboneuhynljuojoty|qjkqboneuhynljuojoty@gmail.com|qjkqboneuhynljuojoty
cmhtkjpfjqcbinzvdfxm|cmhtkjpfjqcbinzvdfxm@gmail.com|cmhtkjpfjqcbinzvdfxm
qjybunjjgadcsrjktgrq|qjybunjjgadcsrjktgrq@gmail.com|qjybunjjgadcsrjktgrq
qjttwmcslbwibmtsutvq|qjttwmcslbwibmtsutvq@gmail.com|qjttwmcslbwibmtsutvq
rcmjohuwinedsktzredz|rcmjohuwinedsktzredz@gmail.com|rcmjohuwinedsktzredz
zjazrnkjgindcmcbkpbq|zjazrnkjgindcmcbkpbq@gmail.com|zjazrnkjgindcmcbkpbq
sodyrjwrnnpgmzftzxjh|sodyrjwrnnpgmzftzxjh@gmail.com|sodyrjwrnnpgmzftzxjh
fimfxfocrmgcwnhnqdhd|fimfxfocrmgcwnhnqdhd@gmail.com|fimfxfocrmgcwnhnqdhd
bllivkecdstffcxrrpta|bllivkecdstffcxrrpta@gmail.com|bllivkecdstffcxrrpta
czkinrrrgjgzygmndvlq|czkinrrrgjgzygmndvlq@gmail.com|czkinrrrgjgzygmndvlq
qqkdlxwlugfdyigtuirm|qqkdlxwlugfdyigtuirm@gmail.com|qqkdlxwlugfdyigtuirm
ozyrexzozxuibhzzfgna|ozyrexzozxuibhzzfgna@gmail.com|ozyrexzozxuibhzzfgna
mdcnnwgmvxpqquaitimh|mdcnnwgmvxpqquaitimh@gmail.com|mdcnnwgmvxpqquaitimh
htzkrmvinwwepqkisamt|htzkrmvinwwepqkisamt@gmail.com|htzkrmvinwwepqkisamt
oaqfcrpdfefinqktdpri|oaqfcrpdfefinqktdpri@gmail.com|oaqfcrpdfefinqktdpri
oylqmlsgwcnytybhobxc|oylqmlsgwcnytybhobxc@gmail.com|oylqmlsgwcnytybhobxc
gkgvzrbgcotxsioxdrty|gkgvzrbgcotxsioxdrty@gmail.com|gkgvzrbgcotxsioxdrty
jfgtbzkjdquwylvwcakz|jfgtbzkjdquwylvwcakz@gmail.com|jfgtbzkjdquwylvwcakz
dqleyrmgyflxmgskvfgm|dqleyrmgyflxmgskvfgm@gmail.com|dqleyrmgyflxmgskvfgm
pfvinlkgupafhztwhbuv|pfvinlkgupafhztwhbuv@gmail.com|pfvinlkgupafhztwhbuv
iojkmplrcyrrdaiygnnu|iojkmplrcyrrdaiygnnu@gmail.com|iojkmplrcyrrdaiygnnu
slgdwatsukqlkacvjwnv|slgdwatsukqlkacvjwnv@gmail.com|slgdwatsukqlkacvjwnv
vxqdemkpxvfnidfxlsia|vxqdemkpxvfnidfxlsia@gmail.com|vxqdemkpxvfnidfxlsia
brmywbjqjjflzcktmrki|brmywbjqjjflzcktmrki@gmail.com|brmywbjqjjflzcktmrki
jqbtjmhozcyixdnhbpem|jqbtjmhozcyixdnhbpem@gmail.com|jqbtjmhozcyixdnhbpem
kdgdncecdjhemdmdmisl|kdgdncecdjhemdmdmisl@gmail.com|kdgdncecdjhemdmdmisl
pqtbwnlqzcnblhnkorwt|pqtbwnlqzcnblhnkorwt@gmail.com|pqtbwnlqzcnblhnkorwt
ehuticbrfuzlnhyvoedw|ehuticbrfuzlnhyvoedw@gmail.com|ehuticbrfuzlnhyvoedw
bxrgyfrhzgkaqkbgatou|bxrgyfrhzgkaqkbgatou@gmail.com|bxrgyfrhzgkaqkbgatou
ldaexyetasdvvxrwziyg|ldaexyetasdvvxrwziyg@gmail.com|ldaexyetasdvvxrwziyg
glccpiwuehcxwocvvxmc|glccpiwuehcxwocvvxmc@gmail.com|glccpiwuehcxwocvvxmc
pelioognognohsfpnkgh|pelioognognohsfpnkgh@gmail.com|pelioognognohsfpnkgh
wmfkdqkyhurubyggchtz|wmfkdqkyhurubyggchtz@gmail.com|wmfkdqkyhurubyggchtz
sasvbxjahqigeaxjtmnl|sasvbxjahqigeaxjtmnl@gmail.com|sasvbxjahqigeaxjtmnl
vwfihmagdytmylpdyhkd|vwfihmagdytmylpdyhkd@gmail.com|vwfihmagdytmylpdyhkd
ldtzcappppucbtzlgosi|ldtzcappppucbtzlgosi@gmail.com|ldtzcappppucbtzlgosi
dcpdxnoqlckcncgzxqkt|dcpdxnoqlckcncgzxqkt@gmail.com|dcpdxnoqlckcncgzxqkt
hczbagitlwixzrrkpfee|hczbagitlwixzrrkpfee@gmail.com|hczbagitlwixzrrkpfee
ppwjzpnwrvpuafiawjjc|ppwjzpnwrvpuafiawjjc@gmail.com|ppwjzpnwrvpuafiawjjc
vjhgtmccfyjcpzarcmrl|vjhgtmccfyjcpzarcmrl@gmail.com|vjhgtmccfyjcpzarcmrl
kljyispwqtxufehxysov|kljyispwqtxufehxysov@gmail.com|kljyispwqtxufehxysov
qvhhzricuqfynhdydiir|qvhhzricuqfynhdydiir@gmail.com|qvhhzricuqfynhdydiir
pttuzqxkwusljpiyowak|pttuzqxkwusljpiyowak@gmail.com|pttuzqxkwusljpiyowak
fgabkirbtvaqjtzrjkhm|fgabkirbtvaqjtzrjkhm@gmail.com|fgabkirbtvaqjtzrjkhm
wzkqcpykcftrkazghwwf|wzkqcpykcftrkazghwwf@gmail.com|wzkqcpykcftrkazghwwf
dsdzsaleogdgqawuxkcq|dsdzsaleogdgqawuxkcq@gmail.com|dsdzsaleogdgqawuxkcq
smukbgbuwlbvzgewoiqf|smukbgbuwlbvzgewoiqf@gmail.com|smukbgbuwlbvzgewoiqf
clmjufbjyggtqebmynhw|clmjufbjyggtqebmynhw@gmail.com|clmjufbjyggtqebmynhw
vkkxqbxpycybngeceked|vkkxqbxpycybngeceked@gmail.com|vkkxqbxpycybngeceked
rsqtysjmeypbmjvcayfn|rsqtysjmeypbmjvcayfn@gmail.com|rsqtysjmeypbmjvcayfn
yaaznwfluloavgsqpzal|yaaznwfluloavgsqpzal@gmail.com|yaaznwfluloavgsqpzal
issgfongqnibulibzpjw|issgfongqnibulibzpjw@gmail.com|issgfongqnibulibzpjw
xnrcleqnbgllddwfdkbx|xnrcleqnbgllddwfdkbx@gmail.com|xnrcleqnbgllddwfdkbx
lkvaguvqynevojhljera|lkvaguvqynevojhljera@gmail.com|lkvaguvqynevojhljera
iaaskujaefkxtbmcktiw|iaaskujaefkxtbmcktiw@gmail.com|iaaskujaefkxtbmcktiw
vdnilwxjdegjmsjkqwrv|vdnilwxjdegjmsjkqwrv@gmail.com|vdnilwxjdegjmsjkqwrv
fslmzjzlznknlfxhopow|fslmzjzlznknlfxhopow@gmail.com|fslmzjzlznknlfxhopow
azlglezycwgaxnokrnki|azlglezycwgaxnokrnki@gmail.com|azlglezycwgaxnokrnki
wircxdthgtnshedjfbui|wircxdthgtnshedjfbui@gmail.com|wircxdthgtnshedjfbui
gydvbzyaiozwxtfboaci|gydvbzyaiozwxtfboaci@gmail.com|gydvbzyaiozwxtfboaci
vzlsanhihbnvsksxfzos|vzlsanhihbnvsksxfzos@gmail.com|vzlsanhihbnvsksxfzos
sngmeayolfugqxnsgxei|sngmeayolfugqxnsgxei@gmail.com|sngmeayolfugqxnsgxei
etiydtqyvfodgdnipqez|etiydtqyvfodgdnipqez@gmail.com|etiydtqyvfodgdnipqez
kttphoarfthvrjaajrdr|kttphoarfthvrjaajrdr@gmail.com|kttphoarfthvrjaajrdr
iflycqujffookvjoanut|iflycqujffookvjoanut@gmail.com|iflycqujffookvjoanut
wfsgdfrierdorynzbjlr|wfsgdfrierdorynzbjlr@gmail.com|wfsgdfrierdorynzbjlr
fqmhtfwxdlslisbeqxuz|fqmhtfwxdlslisbeqxuz@gmail.com|fqmhtfwxdlslisbeqxuz
qhwnohovikgvnqbtzncm|qhwnohovikgvnqbtzncm@gmail.com|qhwnohovikgvnqbtzncm
mlvfxeazecafmcpqdimt|mlvfxeazecafmcpqdimt@gmail.com|mlvfxeazecafmcpqdimt
xviigfbbtzdbxfxemuxh|xviigfbbtzdbxfxemuxh@gmail.com|xviigfbbtzdbxfxemuxh
kspysiasfrigiqvustvl|kspysiasfrigiqvustvl@gmail.com|kspysiasfrigiqvustvl
hsfphqonksowegpploeg|hsfphqonksowegpploeg@gmail.com|hsfphqonksowegpploeg
roctljorvydmhpdftgir|roctljorvydmhpdftgir@gmail.com|roctljorvydmhpdftgir
mpkucuzgogojydhsrztn|mpkucuzgogojydhsrztn@gmail.com|mpkucuzgogojydhsrztn
fxumrykqoqynlqzotyrn|fxumrykqoqynlqzotyrn@gmail.com|fxumrykqoqynlqzotyrn
itfgcfwbqapxxvkpebou|itfgcfwbqapxxvkpebou@gmail.com|itfgcfwbqapxxvkpebou
eybuwiberlbxvehekklj|eybuwiberlbxvehekklj@gmail.com|eybuwiberlbxvehekklj
ezcieykyymszrrnjimrv|ezcieykyymszrrnjimrv@gmail.com|ezcieykyymszrrnjimrv
ryyzhukhxbvsvkdhslct|ryyzhukhxbvsvkdhslct@gmail.com|ryyzhukhxbvsvkdhslct
lhkmjshwntjjwusgwytv|lhkmjshwntjjwusgwytv@gmail.com|lhkmjshwntjjwusgwytv
wsluapelzhkjgtprzess|wsluapelzhkjgtprzess@gmail.com|wsluapelzhkjgtprzess
kgdwsbdmdasrrvbpyojw|kgdwsbdmdasrrvbpyojw@gmail.com|kgdwsbdmdasrrvbpyojw
gyeeyuawymamnfzqpwci|gyeeyuawymamnfzqpwci@gmail.com|gyeeyuawymamnfzqpwci
xjvfkmluvmamtsqvoydz|xjvfkmluvmamtsqvoydz@gmail.com|xjvfkmluvmamtsqvoydz
drpyhkpzlvrvltbhwtem|drpyhkpzlvrvltbhwtem@gmail.com|drpyhkpzlvrvltbhwtem
hzyecgeondggmbacgfqt|hzyecgeondggmbacgfqt@gmail.com|hzyecgeondggmbacgfqt
lzqynjwwowkqidgzqkwx|lzqynjwwowkqidgzqkwx@gmail.com|lzqynjwwowkqidgzqkwx
hlhrwhenadeqlzzodzpu|hlhrwhenadeqlzzodzpu@gmail.com|hlhrwhenadeqlzzodzpu
yvxgktoodegkflpeounu|yvxgktoodegkflpeounu@gmail.com|yvxgktoodegkflpeounu
dfcbuakuwetyyyinvgmf|dfcbuakuwetyyyinvgmf@gmail.com|dfcbuakuwetyyyinvgmf
sijlomydpmegdnxfqrle|sijlomydpmegdnxfqrle@gmail.com|sijlomydpmegdnxfqrle
hclhsiwxuxlwgogfjjwc|hclhsiwxuxlwgogfjjwc@gmail.com|hclhsiwxuxlwgogfjjwc
cakxuexqrbbxfweqhjup|cakxuexqrbbxfweqhjup@gmail.com|cakxuexqrbbxfweqhjup
ygqjyfswlfrrrpipzuso|ygqjyfswlfrrrpipzuso@gmail.com|ygqjyfswlfrrrpipzuso
ninhxcgdrqvuoozwbbxz|ninhxcgdrqvuoozwbbxz@gmail.com|ninhxcgdrqvuoozwbbxz
vjxcdfpobssecomgkjfc|vjxcdfpobssecomgkjfc@gmail.com|vjxcdfpobssecomgkjfc
gspdlegydyfqfjjspxda|gspdlegydyfqfjjspxda@gmail.com|gspdlegydyfqfjjspxda
tsynldojjsnnxdhskuam|tsynldojjsnnxdhskuam@gmail.com|tsynldojjsnnxdhskuam
lqnspkqumvikqzeyjzxt|lqnspkqumvikqzeyjzxt@gmail.com|lqnspkqumvikqzeyjzxt
dlhjfaksqpjnjffvzjcg|dlhjfaksqpjnjffvzjcg@gmail.com|dlhjfaksqpjnjffvzjcg
yhfbvtxnmognrfbobewi|yhfbvtxnmognrfbobewi@gmail.com|yhfbvtxnmognrfbobewi
zokxwrlrdulqfgythqev|zokxwrlrdulqfgythqev@gmail.com|zokxwrlrdulqfgythqev
nyfulkhdnyhdxmaqmgai|nyfulkhdnyhdxmaqmgai@gmail.com|nyfulkhdnyhdxmaqmgai
apslewrxcagwyejcreot|apslewrxcagwyejcreot@gmail.com|apslewrxcagwyejcreot
sxcaksozfpqkajfkmqhy|sxcaksozfpqkajfkmqhy@gmail.com|sxcaksozfpqkajfkmqhy
